train_size0,train_size1,train_size2,test_size0,test_size1,test_size2,train_imb0,train_imb1,train_imb2,test_imb0,test_imb1,test_imb2
24,32,24,16,8,16,0.833333333,0.84375,0.875,0.875,0.875,0.8125
9,42,39,36,3,6,0.555555556,0.5,0.512820513,0.5,0.666666667,0.5
53,30,51,14,37,16,0.773584906,0.6,0.843137255,0.714285714,0.891891892,0.5
85,69,36,10,26,59,0.929411765,0.971014493,0.833333333,0.9,0.807692308,0.983050847
52,37,59,22,37,15,0.865384615,0.891891892,0.847457627,0.863636364,0.837837838,0.933333333
40,64,66,45,21,19,0.925,0.859375,0.878787879,0.844444444,0.952380952,0.894736842
61,79,62,40,22,39,0.442622951,0.518987342,0.419354839,0.5,0.272727273,0.538461538
76,32,70,13,57,19,0.815789474,0.75,0.828571429,0.769230769,0.842105263,0.736842105
49,49,52,26,26,23,0.571428571,0.489795918,0.538461538,0.461538462,0.615384615,0.52173913
72,54,76,29,47,25,0.180555556,0.166666667,0.157894737,0.137931034,0.170212766,0.2
69,58,83,36,47,22,0.898550725,0.896551724,0.915662651,0.916666667,0.914893617,0.863636364
65,70,65,35,30,35,0.892307692,0.871428571,0.938461538,0.914285714,0.966666667,0.828571429
57,48,53,22,31,26,0.368421053,0.375,0.358490566,0.363636364,0.35483871,0.384615385
61,79,62,40,22,39,0.459016393,0.493670886,0.403225806,0.45,0.318181818,0.538461538
49,51,46,24,22,27,0.489795918,0.37254902,0.369565217,0.25,0.5,0.481481481
51,50,57,28,29,22,0.352941176,0.36,0.245614035,0.25,0.24137931,0.5
52,52,60,30,30,22,0.346153846,0.442307692,0.416666667,0.5,0.333333333,0.363636364
67,66,75,37,38,29,0.880597015,0.909090909,0.92,0.945945946,0.894736842,0.862068966
61,79,62,40,22,39,0.475409836,0.518987342,0.419354839,0.475,0.318181818,0.564102564
74,69,73,34,39,35,0.837837838,0.826086957,0.863013699,0.852941176,0.871794872,0.8
68,74,60,33,27,41,0.161764706,0.175675676,0.233333333,0.242424242,0.222222222,0.12195122
68,74,60,33,27,41,0.441176471,0.459459459,0.4,0.424242424,0.37037037,0.487804878
64,59,65,30,35,29,0.203125,0.186440678,0.215384615,0.2,0.228571429,0.172413793
72,64,66,29,37,35,0.208333333,0.125,0.166666667,0.068965517,0.243243243,0.171428571
60,56,62,29,33,27,0.333333333,0.321428571,0.322580645,0.310344828,0.333333333,0.333333333
68,65,69,33,36,32,0.705882353,0.753846154,0.739130435,0.787878788,0.694444444,0.71875
75,76,63,32,31,44,0.213333333,0.118421053,0.142857143,0.03125,0.258064516,0.181818182
67,48,81,31,50,17,0.791044776,0.6875,0.716049383,0.612903226,0.78,0.823529412
58,72,70,42,28,30,0.482758621,0.444444444,0.514285714,0.476190476,0.571428571,0.4
69,68,73,36,37,32,0.739130435,0.794117647,0.780821918,0.833333333,0.72972973,0.75
63,75,68,40,28,35,0.53968254,0.626666667,0.602941176,0.675,0.5,0.571428571
69,73,72,38,34,35,0.695652174,0.684931507,0.694444444,0.684210526,0.705882353,0.685714286
17,22,25,15,10,7,0.764705882,0.772727273,0.88,0.866666667,0.9,0.571428571
77,56,81,30,51,26,0.961038961,0.928571429,0.938271605,0.9,0.960784314,0.961538462
59,24,59,12,47,12,0.627118644,0.291666667,0.677966102,0.416666667,0.744680851,0.166666667
54,49,53,24,29,25,0.388888889,0.346938776,0.339622642,0.291666667,0.379310345,0.4
82,85,11,7,4,78,0.914634146,0.917647059,0.818181818,0.857142857,0.75,0.923076923
52,42,66,28,38,14,0.365384615,0.214285714,0.272727273,0.142857143,0.368421053,0.357142857
39,29,36,13,23,16,0.41025641,0.586206897,0.583333333,0.846153846,0.434782609,0.375
24,54,58,44,14,10,0.833333333,0.944444444,0.948275862,0.977272727,0.857142857,0.8
60,54,60,27,33,27,0.416666667,0.481481481,0.383333333,0.444444444,0.333333333,0.518518519
38,38,20,10,10,28,0.105263158,0.105263158,0.1,0.1,0.1,0.107142857
65,62,61,29,32,33,0.353846154,0.338709677,0.327868852,0.310344828,0.34375,0.363636364
68,61,65,29,36,32,0.058823529,0.06557377,0.030769231,0.034482759,0.027777778,0.09375
51,51,40,20,20,31,0.333333333,0.274509804,0.225,0.15,0.3,0.35483871
71,45,104,39,65,6,0.154929577,0.088888889,0.125,0.076923077,0.153846154,0.166666667
59,93,48,41,7,52,0.949152542,0.967741935,0.958333333,0.975609756,0.857142857,0.961538462
67,60,67,30,37,30,0.373134328,0.45,0.358208955,0.433333333,0.297297297,0.466666667
52,49,51,24,27,25,0.461538462,0.387755102,0.490196078,0.416666667,0.555555556,0.36
54,52,62,30,32,22,0.388888889,0.326923077,0.322580645,0.266666667,0.375,0.409090909
44,48,54,29,25,19,0.318181818,0.375,0.37037037,0.413793103,0.32,0.315789474
73,67,68,31,37,36,0.465753425,0.343283582,0.455882353,0.322580645,0.567567568,0.361111111
58,51,59,26,33,25,0.344827586,0.392156863,0.372881356,0.423076923,0.333333333,0.36
66,61,63,29,34,32,0.424242424,0.409836066,0.396825397,0.379310345,0.411764706,0.4375
58,55,53,25,28,30,0.75862069,0.709090909,0.735849057,0.68,0.785714286,0.733333333
74,67,77,35,42,32,0.837837838,0.880597015,0.87012987,0.914285714,0.833333333,0.84375
85,72,53,20,33,52,0.235294118,0.138888889,0.301886792,0.15,0.393939394,0.134615385
63,61,60,29,31,32,0.428571429,0.459016393,0.516666667,0.551724138,0.483870968,0.375
62,94,84,58,26,36,0.903225806,0.914893617,0.904761905,0.913793103,0.884615385,0.916666667
55,51,50,23,27,28,0.527272727,0.490196078,0.48,0.434782609,0.518518519,0.535714286
80,59,79,29,50,30,0.2625,0.152542373,0.278481013,0.172413793,0.34,0.133333333
76,72,76,36,40,36,0.394736842,0.472222222,0.552631579,0.638888889,0.475,0.305555556
78,74,66,31,35,43,0.538461538,0.594594595,0.515151515,0.580645161,0.457142857,0.604651163
78,67,83,36,47,31,0.666666667,0.611940299,0.710843373,0.666666667,0.744680851,0.548387097
62,47,49,17,32,30,0.338709677,0.446808511,0.326530612,0.470588235,0.25,0.433333333
57,55,60,29,31,26,0.49122807,0.527272727,0.583333333,0.620689655,0.548387097,0.423076923
39,14,41,8,33,6,0.564102564,0.285714286,0.585365854,0.375,0.636363636,0.166666667
18,83,89,77,12,6,0.777777778,0.843373494,0.876404494,0.87012987,0.916666667,0.5
66,62,68,32,36,30,0.409090909,0.467741935,0.411764706,0.46875,0.361111111,0.466666667
66,54,62,25,37,29,0.363636364,0.388888889,0.338709677,0.36,0.324324324,0.413793103
81,58,79,28,51,30,0.765432099,0.586206897,0.835443038,0.678571429,0.921568627,0.5
63,56,59,26,33,30,0.444444444,0.464285714,0.406779661,0.423076923,0.393939394,0.5
73,72,73,36,37,36,0.794520548,0.861111111,0.794520548,0.861111111,0.72972973,0.861111111
57,55,56,27,29,28,0.403508772,0.454545455,0.357142857,0.407407407,0.310344828,0.5
64,61,65,31,34,30,0.46875,0.409836066,0.446153846,0.387096774,0.5,0.433333333
78,67,83,36,47,31,0.717948718,0.671641791,0.78313253,0.75,0.808510638,0.580645161
44,62,64,41,23,21,0.795454545,0.870967742,0.890625,0.926829268,0.826086957,0.761904762
73,70,69,33,36,37,0.890410959,0.828571429,0.884057971,0.818181818,0.944444444,0.837837838
71,79,76,42,34,37,0.929577465,0.873417722,0.881578947,0.833333333,0.941176471,0.918918919
65,62,63,30,33,32,0.215384615,0.258064516,0.19047619,0.233333333,0.151515152,0.28125
71,45,104,39,65,6,0.084507042,0.2,0.125,0.205128205,0.076923077,0.166666667
77,67,82,36,46,31,0.831168831,0.835820896,0.829268293,0.833333333,0.826086957,0.838709677
72,66,80,37,43,29,0.652777778,0.560606061,0.6,0.513513514,0.674418605,0.620689655
58,54,60,28,32,26,0.344827586,0.333333333,0.3,0.285714286,0.3125,0.384615385
63,55,62,27,35,28,0.571428571,0.690909091,0.64516129,0.777777778,0.542857143,0.607142857
81,82,85,43,42,39,0.679012346,0.841463415,0.823529412,0.976744186,0.666666667,0.692307692
89,66,91,34,57,32,0.382022472,0.363636364,0.43956044,0.441176471,0.438596491,0.28125
59,85,72,49,23,36,0.389830508,0.470588235,0.486111111,0.530612245,0.391304348,0.388888889
68,67,71,35,36,32,0.161764706,0.164179104,0.14084507,0.142857143,0.138888889,0.1875
61,77,86,51,35,26,0.360655738,0.454545455,0.38372093,0.450980392,0.285714286,0.461538462
75,83,92,50,42,33,0.626666667,0.722891566,0.663043478,0.74,0.571428571,0.696969697
80,70,72,31,41,39,0.8125,0.8,0.763888889,0.741935484,0.780487805,0.846153846
59,61,62,32,30,29,0.542372881,0.508196721,0.532258065,0.5,0.566666667,0.517241379
86,69,83,33,50,36,0.61627907,0.623188406,0.626506024,0.636363636,0.62,0.611111111
61,77,86,51,35,26,0.524590164,0.506493506,0.5,0.490196078,0.514285714,0.538461538
91,64,97,35,62,29,0.89010989,0.921875,0.886597938,0.914285714,0.870967742,0.931034483
9,86,85,81,4,5,0.444444444,0.848837209,0.835294118,0.864197531,0.25,0.6
70,71,59,30,29,41,0.7,0.704225352,0.796610169,0.8,0.793103448,0.634146341
71,45,104,39,65,6,0.126760563,0.133333333,0.125,0.128205128,0.123076923,0.166666667
62,50,58,23,35,27,0.258064516,0.22,0.327586207,0.304347826,0.342857143,0.148148148
67,66,65,32,33,34,0.343283582,0.348484848,0.276923077,0.28125,0.272727273,0.411764706
64,58,62,28,34,30,0.3125,0.310344828,0.258064516,0.25,0.264705882,0.366666667
44,72,92,60,32,12,0.795454545,0.875,0.869565217,0.9,0.8125,0.75
79,79,94,47,47,32,0.164556962,0.101265823,0.180851064,0.127659574,0.234042553,0.0625
61,64,65,34,31,30,0.393442623,0.375,0.369230769,0.352941176,0.387096774,0.4
74,77,77,40,37,37,0.851351351,0.883116883,0.896103896,0.925,0.864864865,0.837837838
68,77,79,44,35,33,0.720588235,0.675324675,0.721518987,0.681818182,0.771428571,0.666666667
64,59,65,30,35,29,0.5,0.491525424,0.476923077,0.466666667,0.485714286,0.517241379
71,45,104,39,65,6,0.098591549,0.111111111,0.096153846,0.102564103,0.092307692,0.166666667
71,45,104,39,65,6,0.281690141,0.244444444,0.240384615,0.205128205,0.261538462,0.5
63,56,63,28,35,28,0.619047619,0.714285714,0.650793651,0.75,0.571428571,0.678571429
64,63,67,33,34,30,0.21875,0.26984127,0.223880597,0.272727273,0.176470588,0.266666667
62,57,59,27,32,30,0.35483871,0.315789474,0.338983051,0.296296296,0.375,0.333333333
58,56,60,29,31,27,0.517241379,0.5,0.4,0.379310345,0.419354839,0.62962963
90,89,77,38,39,51,0.855555556,0.898876404,0.87012987,0.921052632,0.820512821,0.882352941
59,60,65,33,32,27,0.372881356,0.383333333,0.353846154,0.363636364,0.34375,0.407407407
71,45,104,39,65,6,0.253521127,0.311111111,0.230769231,0.256410256,0.215384615,0.666666667
67,64,67,32,35,32,0.52238806,0.5625,0.582089552,0.625,0.542857143,0.5
61,56,59,27,32,29,0.606557377,0.607142857,0.627118644,0.62962963,0.625,0.586206897
68,63,69,32,37,31,0.426470588,0.428571429,0.405797101,0.40625,0.405405405,0.451612903
75,64,73,31,42,33,0.493333333,0.5,0.479452055,0.483870968,0.476190476,0.515151515
68,63,79,37,42,26,0.294117647,0.285714286,0.278481013,0.27027027,0.285714286,0.307692308
59,59,58,29,29,30,0.576271186,0.576271186,0.620689655,0.620689655,0.620689655,0.533333333
69,70,73,37,36,33,0.31884058,0.271428571,0.260273973,0.216216216,0.305555556,0.333333333
70,58,64,26,38,32,0.457142857,0.517241379,0.5,0.576923077,0.447368421,0.46875
68,64,66,31,35,33,0.338235294,0.3125,0.318181818,0.290322581,0.342857143,0.333333333
65,65,64,32,32,33,0.4,0.4,0.4375,0.4375,0.4375,0.363636364
58,53,59,27,32,26,0.551724138,0.622641509,0.525423729,0.592592593,0.46875,0.653846154
70,62,74,33,41,29,0.471428571,0.483870968,0.445945946,0.454545455,0.43902439,0.517241379
60,52,62,27,35,25,0.466666667,0.442307692,0.435483871,0.407407407,0.457142857,0.48
64,60,62,29,33,31,0.4375,0.4,0.419354839,0.379310345,0.454545455,0.419354839
70,62,72,32,40,30,0.314285714,0.306451613,0.291666667,0.28125,0.3,0.333333333
66,63,65,31,34,32,0.393939394,0.365079365,0.353846154,0.322580645,0.382352941,0.40625
67,65,72,35,37,30,0.358208955,0.323076923,0.319444444,0.285714286,0.351351351,0.366666667
82,98,72,44,28,54,0.512195122,0.479591837,0.486111111,0.454545455,0.535714286,0.5
62,94,84,58,26,36,0.903225806,0.914893617,0.904761905,0.913793103,0.884615385,0.916666667
66,67,73,37,36,30,0.333333333,0.328358209,0.301369863,0.297297297,0.305555556,0.366666667
55,79,78,51,27,28,0.872727273,0.962025316,0.897435897,0.960784314,0.777777778,0.964285714
74,86,82,47,35,39,0.905405405,0.813953488,0.792682927,0.723404255,0.885714286,0.923076923
89,73,92,38,54,35,0.483146067,0.493150685,0.467391304,0.473684211,0.462962963,0.514285714
83,73,80,35,45,38,0.590361446,0.698630137,0.65,0.771428571,0.555555556,0.631578947
74,62,74,31,43,31,0.540540541,0.532258065,0.554054054,0.548387097,0.558139535,0.516129032
59,58,63,31,32,27,0.406779661,0.448275862,0.444444444,0.483870968,0.40625,0.407407407
71,62,69,30,39,32,0.394366197,0.419354839,0.405797101,0.433333333,0.384615385,0.40625
66,60,66,30,36,30,0.712121212,0.716666667,0.727272727,0.733333333,0.722222222,0.7
101,83,54,18,36,65,0.831683168,0.903614458,0.796296296,0.944444444,0.722222222,0.892307692
74,75,83,42,41,33,0.486486486,0.6,0.542168675,0.642857143,0.43902439,0.545454545
57,61,60,32,28,29,0.649122807,0.606557377,0.633333333,0.59375,0.678571429,0.620689655
69,65,72,34,38,31,0.623188406,0.692307692,0.638888889,0.705882353,0.578947368,0.677419355
72,65,71,32,39,33,0.319444444,0.323076923,0.309859155,0.3125,0.307692308,0.333333333
67,62,69,32,37,30,0.507462687,0.548387097,0.52173913,0.5625,0.486486486,0.533333333
64,63,63,31,32,32,0.328125,0.380952381,0.301587302,0.35483871,0.25,0.40625
87,78,91,41,50,37,0.379310345,0.384615385,0.428571429,0.43902439,0.42,0.324324324
69,64,73,34,39,30,0.362318841,0.296875,0.328767123,0.264705882,0.384615385,0.333333333
55,54,55,27,28,27,0.472727273,0.5,0.490909091,0.518518519,0.464285714,0.481481481
70,61,73,32,41,29,0.4,0.409836066,0.397260274,0.40625,0.390243902,0.413793103
72,63,73,32,41,31,0.416666667,0.412698413,0.356164384,0.34375,0.365853659,0.483870968
69,66,75,36,39,30,0.47826087,0.409090909,0.373333333,0.305555556,0.435897436,0.533333333
60,95,95,65,30,30,0.266666667,0.263157895,0.242105263,0.246153846,0.233333333,0.3
86,69,83,33,50,36,0.604651163,0.579710145,0.626506024,0.606060606,0.64,0.555555556
61,57,60,28,32,29,0.393442623,0.350877193,0.366666667,0.321428571,0.40625,0.379310345
67,62,69,32,37,30,0.47761194,0.467741935,0.420289855,0.40625,0.432432432,0.533333333
68,64,68,32,36,32,0.588235294,0.578125,0.632352941,0.625,0.638888889,0.53125
89,66,91,34,57,32,0.966292135,0.954545455,0.956043956,0.941176471,0.964912281,0.96875
67,61,72,33,39,28,0.462686567,0.442622951,0.444444444,0.424242424,0.461538462,0.464285714
39,53,54,34,20,19,0.948717949,0.962264151,0.962962963,0.970588235,0.95,0.947368421
61,57,62,29,33,28,0.672131148,0.614035088,0.677419355,0.620689655,0.727272727,0.607142857
65,58,67,30,37,28,0.553846154,0.603448276,0.582089552,0.633333333,0.540540541,0.571428571
87,69,88,35,53,34,0.218390805,0.173913043,0.170454545,0.114285714,0.20754717,0.235294118
66,63,71,34,37,29,0.742424242,0.761904762,0.774647887,0.794117647,0.756756757,0.724137931
98,64,86,26,60,38,0.857142857,0.796875,0.895348837,0.846153846,0.916666667,0.763157895
56,59,59,31,28,28,0.607142857,0.661016949,0.593220339,0.64516129,0.535714286,0.678571429
69,68,71,35,36,33,0.550724638,0.529411765,0.535211268,0.514285714,0.555555556,0.545454545
75,70,83,39,44,31,0.36,0.342857143,0.301204819,0.282051282,0.318181818,0.419354839
66,65,71,35,36,30,0.590909091,0.569230769,0.563380282,0.542857143,0.583333333,0.6
63,61,66,32,34,29,0.428571429,0.459016393,0.378787879,0.40625,0.352941176,0.517241379
75,69,80,37,43,32,0.173333333,0.202898551,0.1875,0.216216216,0.162790698,0.1875
64,54,64,27,37,27,0.390625,0.407407407,0.359375,0.37037037,0.351351351,0.444444444
58,56,60,29,31,27,0.5,0.482142857,0.5,0.482758621,0.516129032,0.481481481
87,102,73,44,29,58,0.402298851,0.303921569,0.328767123,0.227272727,0.482758621,0.362068966
69,63,68,31,37,32,0.449275362,0.380952381,0.426470588,0.35483871,0.486486486,0.40625
66,65,73,36,37,29,0.454545455,0.538461538,0.452054795,0.527777778,0.378378378,0.551724138
61,63,70,36,34,27,0.524590164,0.523809524,0.528571429,0.527777778,0.529411765,0.518518519
68,69,73,37,36,32,0.514705882,0.463768116,0.479452055,0.432432432,0.527777778,0.5
86,72,86,36,50,36,0.511627907,0.458333333,0.5,0.444444444,0.54,0.472222222
73,63,72,31,41,32,0.356164384,0.333333333,0.347222222,0.322580645,0.365853659,0.34375
68,69,71,36,35,33,0.367647059,0.347826087,0.267605634,0.25,0.285714286,0.454545455
93,83,82,36,46,47,0.075268817,0.060240964,0.048780488,0.027777778,0.065217391,0.085106383
81,82,85,43,42,39,0.567901235,0.62195122,0.717647059,0.76744186,0.666666667,0.461538462
91,88,75,36,39,52,0.340659341,0.352272727,0.346666667,0.361111111,0.333333333,0.346153846
62,58,66,31,35,27,0.403225806,0.465517241,0.333333333,0.387096774,0.285714286,0.555555556
68,66,72,35,37,31,0.397058824,0.318181818,0.333333333,0.257142857,0.405405405,0.387096774
74,70,72,34,38,36,0.540540541,0.485714286,0.527777778,0.470588235,0.578947368,0.5
69,67,78,38,40,29,0.289855072,0.268656716,0.282051282,0.263157895,0.3,0.275862069
72,66,70,32,38,34,0.416666667,0.484848485,0.428571429,0.5,0.368421053,0.470588235
85,75,72,31,41,44,0.870588235,0.853333333,0.861111111,0.838709677,0.87804878,0.863636364
71,66,75,35,40,31,0.309859155,0.303030303,0.266666667,0.257142857,0.275,0.35483871
60,95,95,65,30,30,0.733333333,0.821052632,0.821052632,0.861538462,0.733333333,0.733333333
79,79,94,47,47,32,0.075949367,0.063291139,0.031914894,0.021276596,0.042553191,0.125
68,66,66,32,34,34,0.617647059,0.666666667,0.696969697,0.75,0.647058824,0.588235294
70,63,69,31,38,32,0.628571429,0.714285714,0.68115942,0.774193548,0.605263158,0.65625
68,61,69,31,38,30,0.352941176,0.31147541,0.304347826,0.258064516,0.342105263,0.366666667
81,82,85,43,42,39,0.728395062,0.768292683,0.776470588,0.813953488,0.738095238,0.717948718
91,80,89,39,50,41,0.714285714,0.7125,0.719101124,0.717948718,0.72,0.707317073
82,88,88,47,41,41,0.414634146,0.329545455,0.375,0.29787234,0.463414634,0.365853659
98,57,77,18,59,39,0.724489796,0.824561404,0.701298701,0.833333333,0.661016949,0.820512821
62,59,71,34,37,25,0.338709677,0.338983051,0.295774648,0.294117647,0.297297297,0.4
66,66,66,33,33,33,0.515151515,0.454545455,0.454545455,0.393939394,0.515151515,0.515151515
64,63,69,34,35,29,0.390625,0.412698413,0.391304348,0.411764706,0.371428571,0.413793103
65,64,65,32,33,32,0.430769231,0.515625,0.446153846,0.53125,0.363636364,0.5
66,62,70,33,37,29,0.439393939,0.419354839,0.442857143,0.424242424,0.459459459,0.413793103
82,88,70,38,32,50,0.93902439,0.943181818,0.942857143,0.947368421,0.9375,0.94
63,65,62,32,30,33,0.619047619,0.538461538,0.580645161,0.5,0.666666667,0.575757576
66,62,70,33,37,29,0.318181818,0.290322581,0.271428571,0.242424242,0.297297297,0.344827586
97,79,86,34,52,45,0.412371134,0.379746835,0.395348837,0.352941176,0.423076923,0.4
67,66,73,36,37,30,0.462686567,0.46969697,0.438356164,0.444444444,0.432432432,0.5
64,58,64,29,35,29,0.484375,0.431034483,0.46875,0.413793103,0.514285714,0.448275862
84,94,70,40,30,54,0.345238095,0.372340426,0.428571429,0.45,0.4,0.314814815
68,73,75,40,35,33,0.220588235,0.287671233,0.16,0.225,0.085714286,0.363636364
84,90,92,49,43,41,0.511904762,0.555555556,0.489130435,0.530612245,0.441860465,0.585365854
22,61,65,52,13,9,0.5,0.409836066,0.523076923,0.461538462,0.769230769,0.111111111
79,81,90,46,44,35,0.582278481,0.641975309,0.622222222,0.673913043,0.568181818,0.6
67,64,65,31,34,33,0.313432836,0.328125,0.338461538,0.35483871,0.323529412,0.303030303
69,64,71,33,38,31,0.507246377,0.484375,0.535211268,0.515151515,0.552631579,0.451612903
70,70,74,37,37,33,0.485714286,0.457142857,0.432432432,0.405405405,0.459459459,0.515151515
71,68,71,34,37,34,0.352112676,0.323529412,0.352112676,0.323529412,0.378378378,0.323529412
61,57,66,31,35,26,0.573770492,0.526315789,0.560606061,0.516129032,0.6,0.538461538
65,65,70,35,35,30,0.523076923,0.507692308,0.471428571,0.457142857,0.485714286,0.566666667
57,59,60,31,29,28,0.649122807,0.627118644,0.666666667,0.64516129,0.689655172,0.607142857
78,68,84,37,47,31,0.307692308,0.352941176,0.285714286,0.324324324,0.255319149,0.387096774
91,86,89,42,47,44,0.846153846,0.802325581,0.876404494,0.833333333,0.914893617,0.772727273
65,60,69,32,37,28,0.476923077,0.5,0.420289855,0.4375,0.405405405,0.571428571
63,61,64,31,33,30,0.349206349,0.31147541,0.359375,0.322580645,0.393939394,0.3
90,81,83,37,46,44,0.366666667,0.259259259,0.289156627,0.162162162,0.391304348,0.340909091
73,71,74,36,38,35,0.205479452,0.225352113,0.175675676,0.194444444,0.157894737,0.257142857
55,58,59,31,28,27,0.636363636,0.551724138,0.559322034,0.483870968,0.642857143,0.62962963
100,86,78,32,46,54,0.24,0.279069767,0.282051282,0.34375,0.239130435,0.240740741
69,68,73,36,37,32,0.246376812,0.279411765,0.191780822,0.222222222,0.162162162,0.34375
72,64,70,31,39,33,0.5,0.515625,0.471428571,0.483870968,0.461538462,0.545454545
71,64,71,32,39,32,0.366197183,0.359375,0.323943662,0.3125,0.333333333,0.40625
57,61,70,37,33,24,0.421052632,0.409836066,0.357142857,0.351351351,0.363636364,0.5
63,54,65,28,37,26,0.285714286,0.277777778,0.230769231,0.214285714,0.243243243,0.346153846
69,71,76,39,37,32,0.304347826,0.323943662,0.289473684,0.307692308,0.27027027,0.34375
64,56,68,30,38,26,0.265625,0.25,0.279411765,0.266666667,0.289473684,0.230769231
74,70,80,38,42,32,0.297297297,0.285714286,0.3,0.289473684,0.30952381,0.28125
75,71,80,38,42,33,0.24,0.323943662,0.2625,0.342105263,0.19047619,0.303030303
57,55,64,31,33,24,0.49122807,0.472727273,0.40625,0.387096774,0.424242424,0.583333333
66,58,62,27,35,31,0.53030303,0.551724138,0.532258065,0.555555556,0.514285714,0.548387097
63,62,67,33,34,29,0.476190476,0.532258065,0.492537313,0.545454545,0.441176471,0.517241379
67,63,72,34,38,29,0.552238806,0.555555556,0.5,0.5,0.5,0.620689655
68,62,66,30,36,32,0.485294118,0.435483871,0.424242424,0.366666667,0.472222222,0.5
62,60,68,33,35,27,0.596774194,0.65,0.588235294,0.636363636,0.542857143,0.666666667
61,59,64,31,33,28,0.540983607,0.491525424,0.53125,0.483870968,0.575757576,0.5
69,67,72,35,37,32,0.260869565,0.223880597,0.208333333,0.171428571,0.243243243,0.28125
85,89,94,49,45,40,0.576470588,0.595505618,0.617021277,0.632653061,0.6,0.55
70,69,75,37,38,32,0.457142857,0.47826087,0.413333333,0.432432432,0.394736842,0.53125
71,64,67,30,37,34,0.366197183,0.421875,0.343283582,0.4,0.297297297,0.441176471
66,64,68,33,35,31,0.348484848,0.375,0.338235294,0.363636364,0.314285714,0.387096774
79,90,85,48,37,42,0.569620253,0.588888889,0.564705882,0.583333333,0.540540541,0.595238095
64,65,71,36,35,29,0.390625,0.446153846,0.366197183,0.416666667,0.314285714,0.482758621
69,62,69,31,38,31,0.507246377,0.516129032,0.507246377,0.516129032,0.5,0.516129032
67,64,65,31,34,33,0.597014925,0.53125,0.461538462,0.387096774,0.529411765,0.666666667
66,60,68,31,37,29,0.409090909,0.383333333,0.382352941,0.35483871,0.405405405,0.413793103
64,53,61,25,36,28,0.40625,0.433962264,0.442622951,0.48,0.416666667,0.392857143
60,53,61,27,34,26,0.466666667,0.396226415,0.409836066,0.333333333,0.470588235,0.461538462
69,63,70,32,38,31,0.52173913,0.53968254,0.514285714,0.53125,0.5,0.548387097
76,67,81,36,45,31,0.25,0.28358209,0.296296296,0.333333333,0.266666667,0.225806452
71,63,68,30,38,33,0.366197183,0.333333333,0.25,0.2,0.289473684,0.454545455
75,59,78,31,47,28,0.453333333,0.406779661,0.461538462,0.419354839,0.489361702,0.392857143
64,59,71,33,38,26,0.53125,0.525423729,0.464788732,0.454545455,0.473684211,0.615384615
72,66,72,33,39,33,0.305555556,0.318181818,0.291666667,0.303030303,0.282051282,0.333333333
59,58,61,30,31,28,0.677966102,0.672413793,0.639344262,0.633333333,0.64516129,0.714285714
68,65,73,35,38,30,0.382352941,0.415384615,0.397260274,0.428571429,0.368421053,0.4
69,66,73,35,38,31,0.47826087,0.484848485,0.479452055,0.485714286,0.473684211,0.483870968
79,89,92,51,41,38,0.455696203,0.505617978,0.510869565,0.549019608,0.463414634,0.447368421
70,64,72,33,39,31,0.385714286,0.359375,0.305555556,0.272727273,0.333333333,0.451612903
67,62,61,28,33,34,0.492537313,0.5,0.426229508,0.428571429,0.424242424,0.558823529
67,60,65,29,36,31,0.492537313,0.5,0.446153846,0.448275862,0.444444444,0.548387097
67,63,70,33,37,30,0.417910448,0.380952381,0.342857143,0.303030303,0.378378378,0.466666667
62,62,62,31,31,31,0.483870968,0.435483871,0.467741935,0.419354839,0.516129032,0.451612903
67,57,68,29,39,28,0.432835821,0.456140351,0.397058824,0.413793103,0.384615385,0.5
78,73,81,38,43,35,0.076923077,0.136986301,0.098765432,0.157894737,0.046511628,0.114285714
66,62,70,33,37,29,0.5,0.467741935,0.457142857,0.424242424,0.486486486,0.517241379
68,68,74,37,37,31,0.455882353,0.441176471,0.418918919,0.405405405,0.432432432,0.483870968
66,62,70,33,37,29,0.409090909,0.5,0.428571429,0.515151515,0.351351351,0.482758621
69,66,77,37,40,29,0.420289855,0.439393939,0.415584416,0.432432432,0.4,0.448275862
67,62,67,31,36,31,0.537313433,0.612903226,0.567164179,0.64516129,0.5,0.580645161
68,63,73,34,39,29,0.279411765,0.26984127,0.246575342,0.235294118,0.256410256,0.310344828
72,58,74,30,44,28,0.583333333,0.672413793,0.608108108,0.7,0.545454545,0.642857143
69,71,70,36,34,35,0.52173913,0.535211268,0.485714286,0.5,0.470588235,0.571428571
66,66,72,36,36,30,0.378787879,0.393939394,0.347222222,0.361111111,0.333333333,0.433333333
66,59,61,27,34,32,0.606060606,0.593220339,0.606557377,0.592592593,0.617647059,0.59375
65,63,70,34,36,29,0.323076923,0.317460317,0.3,0.294117647,0.305555556,0.344827586
63,62,69,34,35,28,0.380952381,0.338709677,0.304347826,0.264705882,0.342857143,0.428571429
80,94,94,54,40,40,0.95,0.914893617,0.914893617,0.888888889,0.95,0.95
74,65,69,30,39,35,0.310810811,0.292307692,0.289855072,0.266666667,0.307692308,0.314285714
66,66,72,36,36,30,0.515151515,0.560606061,0.486111111,0.527777778,0.444444444,0.6
68,63,69,32,37,31,0.573529412,0.587301587,0.550724638,0.5625,0.540540541,0.612903226
72,65,75,34,41,31,0.291666667,0.292307692,0.266666667,0.264705882,0.268292683,0.322580645
65,57,66,29,37,28,0.676923077,0.719298246,0.681818182,0.724137931,0.648648649,0.714285714
70,65,73,34,39,31,0.528571429,0.553846154,0.506849315,0.529411765,0.487179487,0.580645161
67,67,70,35,35,32,0.343283582,0.343283582,0.342857143,0.342857143,0.342857143,0.34375
72,71,71,35,36,36,0.222222222,0.225352113,0.197183099,0.2,0.194444444,0.25
66,61,77,36,41,25,0.424242424,0.409836066,0.376623377,0.361111111,0.390243902,0.48
60,62,66,34,32,28,0.45,0.5,0.424242424,0.470588235,0.375,0.535714286
73,62,79,34,45,28,0.301369863,0.290322581,0.253164557,0.235294118,0.266666667,0.357142857
62,65,69,36,33,29,0.306451613,0.323076923,0.260869565,0.277777778,0.242424242,0.379310345
70,65,73,34,39,31,0.457142857,0.461538462,0.465753425,0.470588235,0.461538462,0.451612903
68,65,71,34,37,31,0.308823529,0.323076923,0.309859155,0.323529412,0.297297297,0.322580645
70,64,74,34,40,30,0.514285714,0.484375,0.5,0.470588235,0.525,0.5
69,64,67,31,36,33,0.391304348,0.40625,0.373134328,0.387096774,0.361111111,0.424242424
64,67,67,35,32,32,0.265625,0.253731343,0.23880597,0.228571429,0.25,0.28125
62,61,67,33,34,28,0.435483871,0.491803279,0.462686567,0.515151515,0.411764706,0.464285714
75,70,83,39,44,31,0.293333333,0.3,0.301204819,0.307692308,0.295454545,0.290322581
65,65,62,31,31,34,0.446153846,0.446153846,0.419354839,0.419354839,0.419354839,0.470588235
65,63,62,30,32,33,0.415384615,0.444444444,0.403225806,0.433333333,0.375,0.454545455
64,63,67,33,34,30,0.484375,0.523809524,0.47761194,0.515151515,0.441176471,0.533333333
63,64,73,37,36,27,0.53968254,0.59375,0.520547945,0.567567568,0.472222222,0.62962963
72,69,73,35,38,34,0.361111111,0.420289855,0.369863014,0.428571429,0.315789474,0.411764706
67,66,67,33,34,33,0.417910448,0.439393939,0.402985075,0.424242424,0.382352941,0.454545455
69,80,81,46,35,34,0.47826087,0.575,0.530864198,0.608695652,0.428571429,0.529411765
66,62,70,33,37,29,0.409090909,0.419354839,0.414285714,0.424242424,0.405405405,0.413793103
63,63,68,34,34,29,0.301587302,0.317460317,0.279411765,0.294117647,0.264705882,0.344827586
105,113,120,64,56,49,0.476190476,0.513274336,0.55,0.578125,0.517857143,0.428571429
68,61,69,31,38,30,0.25,0.245901639,0.231884058,0.225806452,0.236842105,0.266666667
74,75,75,38,37,37,0.324324324,0.413333333,0.386666667,0.473684211,0.297297297,0.351351351
64,63,67,33,34,30,0.421875,0.476190476,0.462686567,0.515151515,0.411764706,0.433333333
76,69,77,35,42,34,0.223684211,0.260869565,0.194805195,0.228571429,0.166666667,0.294117647
108,94,110,48,62,46,0.453703704,0.457446809,0.472727273,0.479166667,0.467741935,0.434782609
70,65,77,36,41,29,0.357142857,0.4,0.350649351,0.388888889,0.317073171,0.413793103
91,91,94,47,47,44,0.912087912,0.879120879,0.882978723,0.85106383,0.914893617,0.909090909
71,67,76,36,40,31,0.309859155,0.328358209,0.289473684,0.305555556,0.275,0.35483871
44,63,73,46,27,17,0.909090909,0.920634921,0.931506849,0.934782609,0.925925926,0.882352941
75,68,75,34,41,34,0.133333333,0.191176471,0.12,0.176470588,0.073170732,0.205882353
65,64,65,32,33,32,0.4,0.484375,0.446153846,0.53125,0.363636364,0.4375
80,82,90,46,44,36,0.5375,0.646341463,0.6,0.695652174,0.5,0.583333333
72,67,79,37,42,30,0.319444444,0.343283582,0.278481013,0.297297297,0.261904762,0.4
66,63,71,34,37,29,0.590909091,0.603174603,0.577464789,0.588235294,0.567567568,0.620689655
72,69,75,36,39,33,0.486111111,0.507246377,0.533333333,0.555555556,0.512820513,0.454545455
69,65,72,34,38,31,0.492753623,0.461538462,0.472222222,0.441176471,0.5,0.483870968
68,64,72,34,38,30,0.529411765,0.546875,0.541666667,0.558823529,0.526315789,0.533333333
70,68,76,37,39,31,0.442857143,0.455882353,0.447368421,0.459459459,0.435897436,0.451612903
72,67,79,37,42,30,0.5,0.537313433,0.506329114,0.540540541,0.476190476,0.533333333
70,69,69,34,35,35,0.242857143,0.260869565,0.246376812,0.264705882,0.228571429,0.257142857
69,61,64,28,36,33,0.31884058,0.37704918,0.296875,0.357142857,0.25,0.393939394
71,70,75,37,38,33,0.591549296,0.585714286,0.573333333,0.567567568,0.578947368,0.606060606
67,66,73,36,37,30,0.417910448,0.439393939,0.397260274,0.416666667,0.378378378,0.466666667
111,98,107,47,60,51,0.387387387,0.428571429,0.38317757,0.425531915,0.35,0.431372549
62,60,68,33,35,27,0.451612903,0.466666667,0.411764706,0.424242424,0.4,0.518518519
64,60,70,33,37,27,0.328125,0.383333333,0.342857143,0.393939394,0.297297297,0.37037037
72,68,80,38,42,30,0.430555556,0.5,0.4625,0.526315789,0.404761905,0.466666667
73,66,73,33,40,33,0.452054795,0.484848485,0.452054795,0.484848485,0.425,0.484848485
73,67,82,38,44,29,0.150684932,0.194029851,0.146341463,0.184210526,0.113636364,0.206896552
63,56,69,31,38,25,0.444444444,0.517857143,0.420289855,0.483870968,0.368421053,0.56
68,62,70,32,38,30,0.338235294,0.370967742,0.285714286,0.3125,0.263157895,0.433333333
72,61,75,32,43,29,0.458333333,0.426229508,0.413333333,0.375,0.441860465,0.482758621
76,70,74,34,40,36,0.368421053,0.385714286,0.364864865,0.382352941,0.35,0.388888889
64,61,69,33,36,28,0.515625,0.540983607,0.492753623,0.515151515,0.472222222,0.571428571
88,101,101,57,44,44,0.977272727,0.97029703,0.97029703,0.964912281,0.977272727,0.977272727
110,104,104,49,55,55,0.872727273,0.884615385,0.826923077,0.836734694,0.818181818,0.927272727
66,61,67,31,36,30,0.363636364,0.409836066,0.343283582,0.387096774,0.305555556,0.433333333
100,89,91,40,51,49,0.25,0.258426966,0.175824176,0.175,0.176470588,0.326530612
71,62,71,31,40,31,0.323943662,0.370967742,0.338028169,0.387096774,0.3,0.35483871
64,62,68,33,35,29,0.25,0.306451613,0.25,0.303030303,0.2,0.310344828
67,66,71,35,36,31,0.507462687,0.515151515,0.535211268,0.542857143,0.527777778,0.483870968
66,64,70,34,36,30,0.363636364,0.390625,0.357142857,0.382352941,0.333333333,0.4
69,66,77,37,40,29,0.47826087,0.560606061,0.519480519,0.594594595,0.45,0.517241379
143,141,140,69,71,72,0.874125874,0.907801418,0.878571429,0.913043478,0.845070423,0.902777778
71,75,78,41,37,34,0.492957746,0.52,0.538461538,0.56097561,0.513513514,0.470588235
78,80,82,42,40,38,0.858974359,0.875,0.865853659,0.880952381,0.85,0.868421053
105,106,117,59,58,47,0.552380952,0.660377358,0.598290598,0.694915254,0.5,0.617021277
44,73,65,47,18,26,0.295454545,0.534246575,0.707692308,0.765957447,0.555555556,0.115384615
81,85,92,48,44,37,0.530864198,0.611764706,0.597826087,0.666666667,0.522727273,0.540540541
100,97,89,43,46,54,0.3,0.309278351,0.359550562,0.372093023,0.347826087,0.259259259
64,63,67,33,34,30,0.328125,0.380952381,0.373134328,0.424242424,0.323529412,0.333333333
66,65,63,31,32,34,0.409090909,0.384615385,0.380952381,0.35483871,0.40625,0.411764706
64,67,71,37,34,30,0.609375,0.582089552,0.591549296,0.567567568,0.617647059,0.6
73,64,69,30,39,34,0.369863014,0.34375,0.304347826,0.266666667,0.333333333,0.411764706
85,59,102,38,64,21,0.976470588,0.966101695,0.980392157,0.973684211,0.984375,0.952380952
121,104,105,44,61,60,0.950413223,0.932692308,0.914285714,0.886363636,0.93442623,0.966666667
94,99,95,50,45,49,0.255319149,0.252525253,0.2,0.2,0.2,0.306122449
65,65,70,35,35,30,0.461538462,0.476923077,0.385714286,0.4,0.371428571,0.566666667
86,86,92,46,46,40,0.581395349,0.686046512,0.684782609,0.782608696,0.586956522,0.575
114,93,75,27,48,66,0.49122807,0.516129032,0.373333333,0.37037037,0.375,0.575757576
68,83,81,48,33,35,0.941176471,0.927710843,0.925925926,0.916666667,0.939393939,0.942857143
107,51,114,29,85,22,0.757009346,0.823529412,0.728070175,0.75862069,0.717647059,0.909090909
87,102,89,52,37,50,0.563218391,0.647058824,0.617977528,0.692307692,0.513513514,0.6
74,72,78,38,40,34,0.310810811,0.263888889,0.230769231,0.184210526,0.275,0.352941176
41,36,29,12,17,24,0.512195122,0.5,0.448275862,0.416666667,0.470588235,0.541666667
107,51,114,29,85,22,0.672897196,0.68627451,0.728070175,0.793103448,0.705882353,0.545454545
92,99,105,56,49,43,0.543478261,0.636363636,0.6,0.678571429,0.510204082,0.581395349
66,63,65,31,34,32,0.5,0.492063492,0.461538462,0.451612903,0.470588235,0.53125
46,103,113,85,28,18,0.847826087,0.922330097,0.902654867,0.929411765,0.821428571,0.888888889
96,101,109,57,52,44,0.541666667,0.594059406,0.587155963,0.631578947,0.538461538,0.545454545
93,83,90,40,50,43,0.870967742,0.903614458,0.911111111,0.95,0.88,0.860465116
68,65,69,33,36,32,0.294117647,0.384615385,0.275362319,0.363636364,0.194444444,0.40625
77,71,84,39,45,32,0.454545455,0.549295775,0.452380952,0.538461538,0.377777778,0.5625
78,71,81,37,44,34,0.320512821,0.366197183,0.333333333,0.378378378,0.295454545,0.352941176
85,92,103,55,48,37,0.517647059,0.630434783,0.601941748,0.690909091,0.5,0.540540541
89,80,85,38,47,42,0.471910112,0.575,0.470588235,0.578947368,0.382978723,0.571428571
107,109,112,57,55,52,0.560747664,0.577981651,0.598214286,0.614035088,0.581818182,0.538461538
63,65,70,36,34,29,0.428571429,0.476923077,0.371428571,0.416666667,0.323529412,0.551724138
103,125,102,62,40,63,0.980582524,0.96,0.950980392,0.935483871,0.975,0.984126984
70,70,74,37,37,33,0.428571429,0.414285714,0.337837838,0.324324324,0.351351351,0.515151515
81,69,92,40,52,29,0.530864198,0.449275362,0.434782609,0.35,0.5,0.586206897
108,94,110,48,62,46,0.851851852,0.85106383,0.763636364,0.75,0.774193548,0.956521739
70,72,74,38,36,34,0.314285714,0.361111111,0.351351351,0.394736842,0.305555556,0.323529412
114,113,121,60,61,53,0.798245614,0.82300885,0.760330579,0.783333333,0.737704918,0.867924528
100,101,95,48,47,53,0.95,0.96039604,0.968421053,0.979166667,0.957446809,0.943396226
93,102,107,58,49,44,0.537634409,0.588235294,0.579439252,0.620689655,0.530612245,0.545454545
121,104,105,44,61,60,0.140495868,0.125,0.152380952,0.136363636,0.163934426,0.116666667
68,66,72,35,37,31,0.485294118,0.5,0.444444444,0.457142857,0.432432432,0.548387097
115,87,102,37,65,50,0.052173913,0.08045977,0.029411765,0.054054054,0.015384615,0.1
115,87,102,37,65,50,0.4,0.402298851,0.401960784,0.405405405,0.4,0.4
121,100,119,49,70,51,0.239669421,0.17,0.201680672,0.12244898,0.257142857,0.215686275
93,94,101,51,50,43,0.52688172,0.606382979,0.554455446,0.62745098,0.48,0.581395349
165,164,139,69,70,95,0.721212121,0.701219512,0.71942446,0.695652174,0.742857143,0.705263158
92,82,92,41,51,41,0.967391304,0.926829268,0.945652174,0.902439024,0.980392157,0.951219512
78,125,141,94,47,31,0.41025641,0.392,0.404255319,0.393617021,0.425531915,0.387096774
114,103,113,51,62,52,0.789473684,0.834951456,0.831858407,0.882352941,0.790322581,0.788461538
69,65,72,34,38,31,0.289855072,0.307692308,0.25,0.264705882,0.236842105,0.35483871
67,68,73,37,36,31,0.23880597,0.279411765,0.260273973,0.297297297,0.222222222,0.258064516
69,88,99,59,40,29,0.376811594,0.363636364,0.383838384,0.372881356,0.4,0.344827586
100,89,91,40,51,49,0.24,0.258426966,0.164835165,0.175,0.156862745,0.326530612
112,94,88,35,53,59,0.303571429,0.404255319,0.386363636,0.542857143,0.283018868,0.322033898
130,99,107,38,69,61,0.530769231,0.525252525,0.551401869,0.552631579,0.550724638,0.508196721
97,87,104,47,57,40,0.958762887,0.965517241,0.971153846,0.978723404,0.964912281,0.95
111,113,120,61,59,52,0.900900901,0.911504425,0.908333333,0.918032787,0.898305085,0.903846154
72,66,78,36,42,30,0.333333333,0.378787879,0.320512821,0.361111111,0.285714286,0.4
96,84,94,41,53,43,0.864583333,0.869047619,0.85106383,0.853658537,0.849056604,0.88372093
122,116,116,55,61,61,0.778688525,0.810344828,0.784482759,0.818181818,0.754098361,0.803278689
43,92,101,75,26,17,0.674418605,0.739130435,0.742574257,0.76,0.692307692,0.647058824
70,68,78,38,40,30,0.485714286,0.5,0.512820513,0.526315789,0.5,0.466666667
40,93,105,79,26,14,0.775,0.795698925,0.80952381,0.810126582,0.807692308,0.714285714
106,102,98,47,51,55,0.594339623,0.578431373,0.632653061,0.617021277,0.647058824,0.545454545
52,92,124,82,42,10,0.807692308,0.858695652,0.862903226,0.87804878,0.833333333,0.7
130,99,107,38,69,61,0.592307692,0.656565657,0.654205607,0.763157895,0.594202899,0.590163934
29,93,94,79,15,14,0.896551724,0.946236559,0.936170213,0.949367089,0.866666667,0.928571429
60,62,66,34,32,28,0.5,0.451612903,0.424242424,0.382352941,0.46875,0.535714286
69,68,73,36,37,32,0.536231884,0.558823529,0.534246575,0.555555556,0.513513514,0.5625
108,99,107,49,58,50,0.074074074,0.090909091,0.08411215,0.102040816,0.068965517,0.08
93,92,105,52,53,40,0.548387097,0.619565217,0.60952381,0.673076923,0.547169811,0.55
97,85,84,36,48,49,0.577319588,0.623529412,0.607142857,0.666666667,0.5625,0.591836735
130,125,141,68,73,57,0.707692308,0.728,0.744680851,0.764705882,0.726027397,0.684210526
70,70,74,37,37,33,0.542857143,0.528571429,0.527027027,0.513513514,0.540540541,0.545454545
123,121,132,65,67,56,0.276422764,0.380165289,0.318181818,0.415384615,0.223880597,0.339285714
35,87,96,74,22,13,0.571428571,0.471264368,0.46875,0.445945946,0.545454545,0.615384615
108,110,108,55,53,55,0.962962963,0.963636364,0.981481481,0.981818182,0.981132075,0.945454545
72,67,77,36,41,31,0.347222222,0.388059701,0.350649351,0.388888889,0.317073171,0.387096774
77,66,65,27,38,39,0.883116883,0.833333333,0.784615385,0.703703704,0.842105263,0.923076923
155,108,119,36,83,72,0.490322581,0.518518519,0.43697479,0.444444444,0.43373494,0.555555556
112,119,119,63,56,56,0.892857143,0.907563025,0.907563025,0.920634921,0.892857143,0.892857143
96,112,112,64,48,48,0.5,0.571428571,0.571428571,0.625,0.5,0.5
75,77,110,56,54,21,0.92,0.935064935,0.972727273,0.982142857,0.962962963,0.80952381
149,129,148,64,84,65,0.255033557,0.201550388,0.256756757,0.203125,0.297619048,0.2
90,96,88,47,41,49,0.288888889,0.239583333,0.238636364,0.191489362,0.292682927,0.285714286
102,87,101,43,58,44,0.62745098,0.712643678,0.653465347,0.744186047,0.586206897,0.681818182
70,66,74,35,39,31,0.571428571,0.606060606,0.540540541,0.571428571,0.512820513,0.64516129
52,45,71,32,39,13,0.115384615,0.644444444,0.352112676,0.75,0.025641026,0.384615385
97,66,75,22,53,44,0.87628866,0.878787879,0.893333333,0.909090909,0.886792453,0.863636364
32,31,31,15,16,16,0.3125,0.290322581,0.35483871,0.333333333,0.375,0.25
93,83,90,40,50,43,0.870967742,0.903614458,0.911111111,0.95,0.88,0.860465116
121,104,105,44,61,60,0.966942149,0.951923077,0.971428571,0.954545455,0.983606557,0.95
147,155,138,73,65,82,0.278911565,0.283870968,0.239130435,0.246575342,0.230769231,0.317073171
110,101,115,53,62,48,0.409090909,0.544554455,0.469565217,0.603773585,0.35483871,0.479166667
128,138,128,69,59,69,0.15625,0.239130435,0.2265625,0.304347826,0.13559322,0.173913043
164,137,173,73,100,64,0.737804878,0.686131387,0.710982659,0.657534247,0.75,0.71875
91,86,103,49,54,37,0.813186813,0.76744186,0.776699029,0.734693878,0.814814815,0.810810811
122,116,116,55,61,61,0.672131148,0.629310345,0.681034483,0.636363636,0.721311475,0.62295082
176,169,191,92,99,77,0.482954545,0.568047337,0.54973822,0.630434783,0.474747475,0.493506494
106,103,111,54,57,49,0.462264151,0.572815534,0.540540541,0.648148148,0.438596491,0.489795918
114,113,121,60,61,53,0.868421053,0.876106195,0.826446281,0.833333333,0.819672131,0.924528302
144,143,149,74,75,69,0.375,0.426573427,0.422818792,0.472972973,0.373333333,0.376811594
55,85,68,49,19,36,0.818181818,0.823529412,0.838235294,0.836734694,0.842105263,0.805555556
75,67,72,32,40,35,0.453333333,0.462686567,0.513888889,0.53125,0.5,0.4
67,145,164,121,43,24,0.880597015,0.944827586,0.93902439,0.958677686,0.88372093,0.875
100,89,91,40,51,49,0.26,0.269662921,0.175824176,0.175,0.176470588,0.346938776
130,109,139,59,80,50,0.3,0.311926606,0.309352518,0.322033898,0.3,0.3
116,119,123,63,60,56,0.948275862,0.924369748,0.943089431,0.920634921,0.966666667,0.928571429
98,102,104,54,50,48,0.653061224,0.696078431,0.644230769,0.685185185,0.6,0.708333333
141,138,139,68,71,70,0.191489362,0.253623188,0.172661871,0.235294118,0.112676056,0.271428571
127,130,141,72,69,58,0.503937008,0.576923077,0.617021277,0.680555556,0.550724638,0.448275862
134,100,134,50,84,50,0.746268657,0.76,0.731343284,0.74,0.726190476,0.78
39,87,92,70,22,17,0.743589744,0.666666667,0.684782609,0.657142857,0.772727273,0.705882353
113,98,119,52,67,46,0.752212389,0.806122449,0.705882353,0.75,0.671641791,0.869565217
156,146,128,59,69,87,0.102564103,0.089041096,0.1171875,0.101694915,0.130434783,0.08045977
136,108,132,52,80,56,0.713235294,0.712962963,0.742424242,0.75,0.7375,0.678571429
121,104,105,44,61,60,0.47107438,0.471153846,0.514285714,0.522727273,0.508196721,0.433333333
61,127,144,105,39,22,0.819672131,0.874015748,0.840277778,0.866666667,0.769230769,0.909090909
146,126,130,55,75,71,0.226027397,0.285714286,0.223076923,0.290909091,0.173333333,0.281690141
122,117,113,54,59,63,0.245901639,0.290598291,0.300884956,0.351851852,0.254237288,0.238095238
134,115,107,44,63,71,0.537313433,0.626086957,0.560747664,0.681818182,0.476190476,0.591549296
122,120,10,4,6,116,0.959016393,0.975,0.4,0.5,0.333333333,0.99137931
162,149,141,64,77,85,0.302469136,0.355704698,0.411347518,0.484375,0.350649351,0.258823529
163,127,158,61,97,66,0.674846626,0.62992126,0.708860759,0.672131148,0.731958763,0.590909091
147,156,151,80,71,76,0.557823129,0.532051282,0.562913907,0.5375,0.591549296,0.526315789
79,76,107,52,55,24,0.974683544,0.973684211,0.981308411,0.980769231,0.981818182,0.958333333
143,123,154,67,87,56,0.951048951,0.967479675,0.954545455,0.970149254,0.942528736,0.964285714
82,97,99,57,42,40,0.43902439,0.536082474,0.505050505,0.578947368,0.404761905,0.475
121,116,121,58,63,58,0.900826446,0.913793103,0.917355372,0.931034483,0.904761905,0.896551724
123,154,173,102,71,52,0.048780488,0.071428571,0.075144509,0.088235294,0.056338028,0.038461538
130,109,139,59,80,50,0.915384615,0.908256881,0.920863309,0.915254237,0.925,0.9
162,159,139,68,71,91,0.833333333,0.842767296,0.81294964,0.823529412,0.802816901,0.857142857
141,115,128,51,77,64,0.354609929,0.330434783,0.28125,0.235294118,0.311688312,0.40625
63,116,103,78,25,38,0.968253968,0.974137931,0.970873786,0.974358974,0.96,0.973684211
136,139,111,57,54,82,0.602941176,0.618705036,0.702702703,0.719298246,0.685185185,0.548780488
149,150,145,73,72,77,0.147651007,0.12,0.096551724,0.068493151,0.125,0.168831169
259,245,266,126,140,119,0.011583012,0.040816327,0.033834586,0.063492063,0.007142857,0.016806723
142,139,139,68,71,71,0.126760563,0.172661871,0.129496403,0.176470588,0.084507042,0.169014085
52,121,131,100,31,21,0.788461538,0.842975207,0.832061069,0.85,0.774193548,0.80952381
118,119,129,65,64,54,0.474576271,0.554621849,0.558139535,0.630769231,0.484375,0.462962963
48,112,116,90,26,22,0.708333333,0.705357143,0.715517241,0.711111111,0.730769231,0.681818182
156,143,161,74,87,69,0.358974359,0.335664336,0.372670807,0.351351351,0.390804598,0.31884058
149,150,145,73,72,77,0.067114094,0.066666667,0.082758621,0.082191781,0.083333333,0.051948052
146,126,130,55,75,71,0.294520548,0.293650794,0.215384615,0.2,0.226666667,0.366197183
107,109,112,57,55,52,0.495327103,0.587155963,0.598214286,0.684210526,0.509090909,0.480769231
98,92,96,45,51,47,0.908163265,0.836956522,0.875,0.8,0.941176471,0.872340426
148,157,151,80,71,77,0.074324324,0.063694268,0.072847682,0.0625,0.084507042,0.064935065
116,121,125,65,60,56,0.517241379,0.545454545,0.608,0.630769231,0.583333333,0.446428571
151,149,148,73,75,76,0.59602649,0.604026846,0.527027027,0.534246575,0.52,0.671052632
102,142,170,105,65,37,0.87254902,0.816901408,0.852941176,0.819047619,0.907692308,0.810810811
123,127,98,51,47,76,0.227642276,0.267716535,0.346938776,0.392156863,0.29787234,0.184210526
149,168,123,71,52,97,0.838926174,0.875,0.829268293,0.873239437,0.769230769,0.87628866
141,128,127,57,70,71,0.475177305,0.453125,0.448818898,0.421052632,0.471428571,0.478873239
161,144,161,72,89,72,0.888198758,0.930555556,0.913043478,0.958333333,0.876404494,0.902777778
140,119,141,60,81,59,0.935714286,0.865546218,0.879432624,0.8,0.938271605,0.93220339
161,146,163,74,89,72,0.850931677,0.863013699,0.852760736,0.864864865,0.842696629,0.861111111
98,105,111,59,52,46,0.510204082,0.580952381,0.567567568,0.627118644,0.5,0.52173913
135,125,136,63,73,62,0.540740741,0.544,0.580882353,0.587301587,0.575342466,0.5
130,159,169,99,70,60,0.815384615,0.786163522,0.810650888,0.787878788,0.842857143,0.783333333
84,177,211,152,59,25,0.833333333,0.807909605,0.838862559,0.822368421,0.881355932,0.72
114,106,120,56,64,50,0.605263158,0.58490566,0.658333333,0.642857143,0.671875,0.52
165,164,139,69,70,95,0.593939394,0.615853659,0.582733813,0.608695652,0.557142857,0.621052632
124,170,172,109,63,61,0.798387097,0.864705882,0.837209302,0.880733945,0.761904762,0.836065574
101,111,114,62,52,49,0.514851485,0.531531532,0.570175439,0.580645161,0.557692308,0.469387755
119,118,131,65,66,53,0.43697479,0.483050847,0.450381679,0.492307692,0.409090909,0.471698113
96,84,82,35,47,49,0.708333333,0.654761905,0.646341463,0.571428571,0.70212766,0.714285714
177,177,106,53,53,124,0.062146893,0.056497175,0.066037736,0.056603774,0.075471698,0.056451613
160,168,148,78,70,90,0.6875,0.696428571,0.682432432,0.692307692,0.671428571,0.7
124,170,172,109,63,61,0.830645161,0.858823529,0.854651163,0.871559633,0.825396825,0.836065574
136,108,132,52,80,56,0.036764706,0.037037037,0.022727273,0.019230769,0.025,0.053571429
128,135,145,76,69,59,0.1015625,0.133333333,0.15862069,0.184210526,0.130434783,0.06779661
154,140,170,78,92,62,0.746753247,0.728571429,0.758823529,0.743589744,0.77173913,0.709677419
115,87,102,37,65,50,0.156521739,0.137931034,0.137254902,0.108108108,0.153846154,0.16
88,70,82,32,50,38,0.761363636,0.814285714,0.853658537,0.9375,0.8,0.710526316
149,126,145,61,84,65,0.44966443,0.404761905,0.455172414,0.409836066,0.488095238,0.4
135,113,134,56,78,57,0.392592593,0.371681416,0.395522388,0.375,0.41025641,0.368421053
168,127,169,64,105,63,0.029761905,0.031496063,0.041420118,0.046875,0.038095238,0.015873016
159,151,168,80,88,71,0.547169811,0.582781457,0.613095238,0.65,0.579545455,0.507042254
143,143,144,72,72,71,0.237762238,0.272727273,0.256944444,0.291666667,0.222222222,0.253521127
130,99,107,38,69,61,0.823076923,0.909090909,0.794392523,0.894736842,0.739130435,0.918032787
234,209,187,81,106,128,0.260683761,0.258373206,0.240641711,0.234567901,0.245283019,0.2734375
148,157,151,80,71,77,0.047297297,0.050955414,0.072847682,0.075,0.070422535,0.025974026
165,164,139,69,70,95,0.593939394,0.579268293,0.496402878,0.47826087,0.514285714,0.652631579
158,128,134,52,82,76,0.569620253,0.5078125,0.544776119,0.461538462,0.597560976,0.539473684
158,149,163,77,86,72,0.765822785,0.785234899,0.797546012,0.818181818,0.779069767,0.75
117,117,108,54,54,63,0.957264957,0.965811966,0.935185185,0.944444444,0.925925926,0.984126984
149,129,148,64,84,65,0.140939597,0.069767442,0.135135135,0.0625,0.19047619,0.076923077
177,154,157,67,90,87,0.186440678,0.188311688,0.165605096,0.164179104,0.166666667,0.206896552
149,150,145,73,72,77,0.134228188,0.106666667,0.096551724,0.068493151,0.125,0.142857143
177,154,157,67,90,87,0.316384181,0.318181818,0.299363057,0.298507463,0.3,0.333333333
94,110,118,67,51,43,0.744680851,0.763636364,0.813559322,0.820895522,0.803921569,0.674418605
170,142,168,70,98,72,0.723529412,0.774647887,0.732142857,0.785714286,0.693877551,0.763888889
62,138,154,115,39,23,0.85483871,0.927536232,0.88961039,0.92173913,0.794871795,0.956521739
95,102,111,59,52,43,0.536842105,0.647058824,0.585585586,0.677966102,0.480769231,0.604651163
145,140,167,81,86,59,0.406896552,0.457142857,0.377245509,0.419753086,0.337209302,0.508474576
172,132,194,77,117,55,0.563953488,0.5,0.572164948,0.519480519,0.606837607,0.472727273
179,172,197,95,102,77,0.134078212,0.127906977,0.111675127,0.105263158,0.117647059,0.155844156
155,144,143,66,77,78,0.15483871,0.173611111,0.118881119,0.136363636,0.103896104,0.205128205
290,315,287,156,131,159,0.220689655,0.282539683,0.337979094,0.391025641,0.27480916,0.176100629
163,127,158,61,97,66,0.877300613,0.913385827,0.917721519,0.967213115,0.886597938,0.863636364
124,149,163,94,69,55,0.14516129,0.147651007,0.159509202,0.159574468,0.15942029,0.127272727
138,141,167,85,82,56,0.036231884,0.035460993,0.023952096,0.023529412,0.024390244,0.053571429
143,111,92,30,62,81,0.461538462,0.531531532,0.380434783,0.466666667,0.338709677,0.555555556
168,160,168,80,88,80,0.125,0.16875,0.19047619,0.2375,0.147727273,0.1
190,147,157,57,100,90,0.268421053,0.238095238,0.229299363,0.175438596,0.26,0.277777778
267,259,246,119,127,140,0.685393258,0.733590734,0.68699187,0.739495798,0.637795276,0.728571429
145,147,138,70,68,77,0.951724138,0.918367347,0.949275362,0.914285714,0.985294118,0.922077922
160,149,175,82,93,67,0.05625,0.033557047,0.068571429,0.048780488,0.086021505,0.014925373
250,221,191,81,110,140,0.26,0.262443439,0.277486911,0.283950617,0.272727273,0.25
162,178,184,100,84,78,0.296296296,0.415730337,0.347826087,0.45,0.226190476,0.371794872
93,161,154,111,43,50,0.752688172,0.782608696,0.857142857,0.846846847,0.88372093,0.64
223,184,225,93,132,91,0.856502242,0.858695652,0.866666667,0.870967742,0.863636364,0.846153846
157,146,167,78,89,68,0.203821656,0.219178082,0.203592814,0.217948718,0.191011236,0.220588235
210,204,154,74,80,130,0.680952381,0.632352941,0.675324675,0.608108108,0.7375,0.646153846
162,137,179,77,102,60,0.358024691,0.386861314,0.340782123,0.363636364,0.323529412,0.416666667
89,63,90,32,58,31,0.775280899,0.714285714,0.733333333,0.65625,0.775862069,0.774193548
172,174,186,94,92,80,0.523255814,0.540229885,0.52688172,0.542553191,0.510869565,0.5375
149,150,145,73,72,77,0.073825503,0.073333333,0.027586207,0.02739726,0.027777778,0.116883117
162,149,141,64,77,85,0.654320988,0.66442953,0.687943262,0.703125,0.675324675,0.635294118
164,175,169,90,79,85,0.164634146,0.165714286,0.177514793,0.177777778,0.17721519,0.152941176
126,93,115,41,74,52,0.222222222,0.258064516,0.260869565,0.317073171,0.22972973,0.211538462
245,182,249,93,156,89,0.534693878,0.43956044,0.510040161,0.408602151,0.570512821,0.471910112
191,183,190,91,99,92,0.19895288,0.229508197,0.178947368,0.208791209,0.151515152,0.25
163,159,174,85,89,74,0.098159509,0.113207547,0.126436782,0.141176471,0.112359551,0.081081081
125,116,133,62,71,54,0.928,0.887931034,0.879699248,0.838709677,0.915492958,0.944444444
209,203,154,74,80,129,0.602870813,0.522167488,0.532467532,0.418918919,0.6375,0.581395349
125,210,209,147,62,63,0.072,0.095238095,0.090909091,0.102040816,0.064516129,0.079365079
238,220,228,105,123,115,0.142857143,0.118181818,0.105263158,0.076190476,0.130081301,0.156521739
149,154,153,79,74,75,0.053691275,0.077922078,0.052287582,0.075949367,0.027027027,0.08
200,193,215,104,111,89,0.94,0.943005181,0.958139535,0.961538462,0.954954955,0.921348315
160,168,148,78,70,90,0.3875,0.43452381,0.439189189,0.487179487,0.385714286,0.388888889
124,170,172,109,63,61,0.814516129,0.794117647,0.790697674,0.779816514,0.80952381,0.819672131
201,168,171,69,102,99,0.960199005,0.94047619,0.941520468,0.913043478,0.960784314,0.95959596
124,170,172,109,63,61,0.508064516,0.635294118,0.552325581,0.642201835,0.396825397,0.62295082
168,160,168,80,88,80,0.18452381,0.24375,0.261904762,0.325,0.204545455,0.1625
169,160,159,75,84,85,0.970414201,0.95,0.943396226,0.92,0.964285714,0.976470588
237,205,186,77,109,128,0.4092827,0.409756098,0.446236559,0.454545455,0.440366972,0.3828125
172,174,186,94,92,80,0.377906977,0.448275862,0.413978495,0.478723404,0.347826087,0.4125
164,175,169,90,79,85,0.304878049,0.342857143,0.319526627,0.355555556,0.278481013,0.329411765
55,106,125,88,37,18,0.418181818,0.632075472,0.608,0.681818182,0.432432432,0.388888889
226,215,213,101,112,114,0.946902655,0.925581395,0.943661972,0.920792079,0.964285714,0.929824561
206,197,185,88,97,109,0.898058252,0.898477157,0.886486486,0.886363636,0.886597938,0.908256881
161,146,163,74,89,72,0.826086957,0.863013699,0.828220859,0.864864865,0.797752809,0.861111111
211,205,154,74,80,131,0.151658768,0.136585366,0.116883117,0.094594595,0.1375,0.160305344
161,159,144,71,73,88,0.962732919,0.962264151,0.958333333,0.957746479,0.95890411,0.965909091
179,137,182,70,112,67,0.217877095,0.255474453,0.197802198,0.228571429,0.178571429,0.28358209
246,256,268,139,129,117,0.906504065,0.8828125,0.921641791,0.899280576,0.945736434,0.863247863
162,137,179,77,102,60,0.728395062,0.700729927,0.726256983,0.701298701,0.745098039,0.7
197,193,190,93,97,100,0.766497462,0.756476684,0.721052632,0.709677419,0.731958763,0.8
247,223,208,92,116,131,0.522267206,0.600896861,0.581730769,0.684782609,0.5,0.541984733
201,168,171,69,102,99,0.094527363,0.154761905,0.111111111,0.188405797,0.058823529,0.131313131
239,203,190,77,113,126,0.338912134,0.36453202,0.384210526,0.428571429,0.353982301,0.325396825
59,48,59,24,35,24,0.474576271,0.458333333,0.508474576,0.5,0.514285714,0.416666667
146,138,140,66,74,72,0.609589041,0.594202899,0.535714286,0.515151515,0.554054054,0.666666667
323,272,307,128,179,144,0.907120743,0.922794118,0.931596091,0.953125,0.916201117,0.895833333
174,150,170,73,97,77,0.91954023,0.946666667,0.905882353,0.931506849,0.886597938,0.961038961
191,181,218,104,114,77,0.968586387,0.977900552,0.963302752,0.971153846,0.956140351,0.987012987
212,201,187,88,99,113,0.929245283,0.915422886,0.935828877,0.920454545,0.949494949,0.911504425
246,221,203,89,114,132,0.548780488,0.628959276,0.591133005,0.696629213,0.50877193,0.583333333
167,161,170,82,88,79,0.329341317,0.285714286,0.311764706,0.268292683,0.352272727,0.303797468
173,153,156,68,88,85,0.040462428,0.026143791,0.032051282,0.014705882,0.045454545,0.035294118
170,142,168,70,98,72,0.235294118,0.281690141,0.273809524,0.328571429,0.234693878,0.236111111
232,210,234,106,128,104,0.461206897,0.480952381,0.452991453,0.471698113,0.4375,0.490384615
223,184,225,93,132,91,0.910313901,0.918478261,0.897777778,0.903225806,0.893939394,0.934065934
170,142,168,70,98,72,0.235294118,0.267605634,0.226190476,0.257142857,0.204081633,0.277777778
139,123,118,51,67,72,0.971223022,0.967479675,0.983050847,0.980392157,0.985074627,0.958333333
208,190,220,101,119,89,0.908653846,0.936842105,0.940909091,0.97029703,0.915966387,0.898876404
243,218,237,106,131,112,0.020576132,0.009174312,0.021097046,0.009433962,0.030534351,0.008928571
143,140,147,72,75,68,0.79020979,0.757142857,0.768707483,0.736111111,0.8,0.779411765
371,329,368,163,205,166,0.134770889,0.133738602,0.163043478,0.165644172,0.16097561,0.102409639
303,250,237,92,145,158,0.927392739,0.916,0.919831224,0.902173913,0.931034483,0.924050633
86,90,88,46,42,44,0.674418605,0.688888889,0.659090909,0.673913043,0.642857143,0.704545455
190,147,157,57,100,90,0.942105263,0.959183673,0.942675159,0.964912281,0.93,0.955555556
198,180,208,95,113,85,0.151515152,0.105555556,0.110576923,0.063157895,0.150442478,0.152941176
218,188,182,76,106,112,0.45412844,0.5,0.5,0.565789474,0.452830189,0.455357143
174,150,170,73,97,77,0.643678161,0.66,0.652941176,0.671232877,0.639175258,0.649350649
260,284,256,140,116,144,0.203846154,0.186619718,0.203125,0.185714286,0.224137931,0.1875
262,248,226,106,120,142,0.973282443,0.975806452,0.977876106,0.981132075,0.975,0.971830986
245,182,249,93,156,89,0.232653061,0.17032967,0.232931727,0.172043011,0.269230769,0.168539326
144,138,132,63,69,75,0.868055556,0.855072464,0.825757576,0.80952381,0.84057971,0.893333333
176,169,191,92,99,77,0.482954545,0.568047337,0.54973822,0.630434783,0.474747475,0.493506494
244,212,188,78,110,134,0.360655738,0.377358491,0.35106383,0.371794872,0.336363636,0.380597015
192,197,205,105,100,92,0.916666667,0.913705584,0.936585366,0.933333333,0.94,0.891304348
235,205,192,81,111,124,0.438297872,0.492682927,0.53125,0.617283951,0.468468468,0.411290323
168,158,176,83,93,75,0.982142857,0.981012658,0.977272727,0.975903614,0.978494624,0.986666667
163,159,174,85,89,74,0.018404908,0.025157233,0.017241379,0.023529412,0.011235955,0.027027027
174,161,191,89,102,72,0.350574713,0.366459627,0.314136126,0.325842697,0.303921569,0.416666667
255,241,230,108,122,133,0.219607843,0.22406639,0.234782609,0.240740741,0.229508197,0.210526316
226,224,196,97,99,127,0.827433628,0.834821429,0.806122449,0.81443299,0.797979798,0.850393701
234,213,237,108,129,105,0.260683761,0.309859155,0.257383966,0.305555556,0.217054264,0.314285714
172,132,194,77,117,55,0.430232558,0.348484848,0.422680412,0.350649351,0.47008547,0.345454545
222,212,184,87,97,125,0.581081081,0.589622642,0.565217391,0.574712644,0.556701031,0.6
152,163,169,90,79,73,0.842105263,0.840490798,0.893491124,0.888888889,0.898734177,0.780821918
324,244,328,124,204,120,0.975308642,0.971311475,0.984756098,0.983870968,0.985294118,0.958333333
229,198,227,98,129,100,0.576419214,0.53030303,0.559471366,0.510204082,0.596899225,0.55
227,194,221,94,127,100,0.057268722,0.051546392,0.049773756,0.042553191,0.05511811,0.06
269,234,267,116,151,118,0.074349442,0.076923077,0.08988764,0.094827586,0.086092715,0.059322034
255,233,224,101,123,132,0.564705882,0.587982833,0.540178571,0.564356436,0.520325203,0.606060606
172,174,186,94,92,80,0.436046512,0.465517241,0.419354839,0.446808511,0.391304348,0.4875
262,203,259,100,159,103,0.160305344,0.123152709,0.181467181,0.15,0.201257862,0.097087379
226,224,196,97,99,127,0.154867257,0.133928571,0.147959184,0.12371134,0.171717172,0.141732283
172,174,186,94,92,80,0.343023256,0.367816092,0.338709677,0.361702128,0.315217391,0.375
251,227,270,123,147,104,0.960159363,0.973568282,0.97037037,0.983739837,0.959183673,0.961538462
136,112,158,67,91,45,0.977941176,0.9375,0.949367089,0.910447761,0.978021978,0.977777778
183,168,199,92,107,76,0.601092896,0.625,0.59798995,0.619565217,0.579439252,0.631578947
234,213,237,108,129,105,0.051282051,0.0657277,0.084388186,0.101851852,0.069767442,0.028571429
248,214,208,87,121,127,0.443548387,0.462616822,0.485576923,0.517241379,0.462809917,0.42519685
76,56,70,25,45,31,0.947368421,0.910714286,0.957142857,0.92,0.977777778,0.903225806
275,249,256,115,141,134,0.432727273,0.481927711,0.51171875,0.573913043,0.460992908,0.402985075
201,168,171,69,102,99,0.885572139,0.863095238,0.883040936,0.855072464,0.901960784,0.868686869
267,269,244,123,121,146,0.142322097,0.185873606,0.196721311,0.243902439,0.148760331,0.136986301
205,188,187,85,102,103,0.112195122,0.117021277,0.13368984,0.141176471,0.12745098,0.097087379
272,262,262,126,136,136,0.102941176,0.145038168,0.129770992,0.174603175,0.088235294,0.117647059
305,237,286,109,177,128,0.904918033,0.907172996,0.905594406,0.908256881,0.903954802,0.90625
160,159,189,94,95,65,0.9375,0.911949686,0.925925926,0.904255319,0.947368421,0.923076923
224,224,212,106,106,118,0.674107143,0.71875,0.698113208,0.745283019,0.650943396,0.694915254
240,210,202,86,116,124,0.341666667,0.366666667,0.361386139,0.395348837,0.336206897,0.346774194
376,287,395,153,242,134,0.454787234,0.327526132,0.458227848,0.339869281,0.533057851,0.313432836
308,309,295,148,147,161,0.071428571,0.116504854,0.122033898,0.168918919,0.074829932,0.068322981
280,259,295,137,158,122,0.746428571,0.764478764,0.769491525,0.788321168,0.753164557,0.737704918
209,196,205,96,109,100,0.511961722,0.56122449,0.551219512,0.604166667,0.504587156,0.52
197,193,190,93,97,100,0.934010152,0.89119171,0.915789474,0.870967742,0.958762887,0.91
262,225,205,84,121,141,0.408396947,0.408888889,0.482926829,0.5,0.47107438,0.354609929
284,260,248,112,136,148,0.253521127,0.226923077,0.213709677,0.178571429,0.242647059,0.263513514
207,177,244,107,137,70,0.922705314,0.920903955,0.93442623,0.934579439,0.934306569,0.9
150,154,148,76,72,78,0.26,0.201298701,0.22972973,0.171052632,0.291666667,0.230769231
205,188,187,85,102,103,0.829268293,0.787234043,0.823529412,0.776470588,0.862745098,0.796116505
260,241,275,128,147,113,0.903846154,0.89626556,0.898181818,0.890625,0.904761905,0.902654867
266,287,277,149,128,138,0.932330827,0.944250871,0.942238267,0.953020134,0.9296875,0.934782609
238,220,228,105,123,115,0.668067227,0.686363636,0.675438596,0.695238095,0.658536585,0.67826087
258,235,223,100,123,135,0.46124031,0.476595745,0.434977578,0.45,0.422764228,0.496296296
247,232,251,118,133,114,0.963562753,0.961206897,0.960159363,0.957627119,0.962406015,0.964912281
219,200,227,104,123,96,0.917808219,0.92,0.911894273,0.913461538,0.910569106,0.927083333
107,235,150,139,11,96,0.485981308,0.523404255,0.526666667,0.539568345,0.363636364,0.5
380,325,383,164,219,161,0.776315789,0.772307692,0.804177546,0.804878049,0.803652968,0.739130435
233,232,229,114,115,118,0.879828326,0.862068966,0.860262009,0.842105263,0.87826087,0.881355932
386,387,391,196,195,191,0.450777202,0.42377261,0.460358056,0.433673469,0.487179487,0.413612565
243,218,237,106,131,112,0.037037037,0.041284404,0.042194093,0.047169811,0.038167939,0.035714286
284,260,248,112,136,148,0.883802817,0.892307692,0.883064516,0.892857143,0.875,0.891891892
237,205,190,79,111,126,0.291139241,0.307317073,0.315789474,0.341772152,0.297297297,0.285714286
385,347,338,150,188,197,0.150649351,0.13832853,0.142011834,0.126666667,0.154255319,0.147208122
243,218,237,106,131,112,0.032921811,0.018348624,0.033755274,0.018867925,0.045801527,0.017857143
240,225,235,110,125,115,0.329166667,0.408888889,0.404255319,0.490909091,0.328,0.330434783
194,217,205,114,91,103,0.453608247,0.391705069,0.453658537,0.394736842,0.527472527,0.388349515
405,379,378,176,202,203,0.088888889,0.110817942,0.084656085,0.107954545,0.064356436,0.113300493
139,145,146,76,70,69,0.230215827,0.268965517,0.253424658,0.289473684,0.214285714,0.246376812
175,128,163,58,105,70,0.805714286,0.78125,0.81595092,0.793103448,0.828571429,0.771428571
304,236,286,109,177,127,0.667763158,0.644067797,0.653846154,0.623853211,0.672316384,0.661417323
259,301,342,192,150,109,0.706563707,0.740863787,0.736842105,0.760416667,0.706666667,0.706422018
268,207,275,107,168,100,0.955223881,0.942028986,0.941818182,0.925233645,0.952380952,0.96
330,261,337,134,203,127,0.981818182,0.980842912,0.979228487,0.97761194,0.980295567,0.984251969
232,210,194,86,108,124,0.443965517,0.466666667,0.479381443,0.511627907,0.453703704,0.435483871
311,274,343,153,190,121,0.08681672,0.083941606,0.081632653,0.078431373,0.084210526,0.090909091
311,311,296,148,148,163,0.987138264,0.971061093,0.976351351,0.959459459,0.993243243,0.981595092
277,283,272,139,133,144,0.942238267,0.939929329,0.930147059,0.928057554,0.932330827,0.951388889
363,363,350,175,175,188,0.170798898,0.134986226,0.185714286,0.148571429,0.222857143,0.122340426
312,317,299,152,147,165,0.080128205,0.119873817,0.117056856,0.157894737,0.074829932,0.084848485
254,217,213,88,125,129,0.244094488,0.262672811,0.276995305,0.306818182,0.256,0.23255814
266,232,248,107,141,125,0.481203008,0.49137931,0.475806452,0.485981308,0.468085106,0.496
242,270,242,135,107,135,0.904958678,0.848148148,0.859504132,0.807407407,0.925233645,0.888888889
267,239,274,123,151,116,0.468164794,0.510460251,0.51459854,0.56097561,0.476821192,0.456896552
278,244,278,122,156,122,0.071942446,0.069672131,0.089928058,0.090163934,0.08974359,0.049180328
338,326,324,156,168,170,0.934911243,0.923312883,0.916666667,0.903846154,0.928571429,0.941176471
239,244,251,128,123,116,0.920502092,0.885245902,0.884462151,0.8515625,0.918699187,0.922413793
332,380,448,248,200,132,0.686746988,0.760526316,0.716517857,0.77016129,0.65,0.742424242
267,259,246,119,127,140,0.730337079,0.756756757,0.727642276,0.756302521,0.700787402,0.757142857
130,144,144,79,65,65,0.415384615,0.4375,0.451388889,0.46835443,0.430769231,0.4
255,234,203,91,112,143,0.294117647,0.346153846,0.344827586,0.417582418,0.285714286,0.300699301
198,228,196,113,83,115,0.404040404,0.513157895,0.505102041,0.601769912,0.373493976,0.426086957
238,220,228,105,123,115,0.903361345,0.9,0.890350877,0.885714286,0.894308943,0.913043478
290,260,282,126,156,134,0.862068966,0.884615385,0.865248227,0.888888889,0.846153846,0.880597015
259,245,266,126,140,119,0.536679537,0.514285714,0.537593985,0.515873016,0.557142857,0.512605042
279,223,276,110,166,113,0.899641577,0.901345291,0.913043478,0.918181818,0.909638554,0.884955752
381,326,383,164,219,162,0.480314961,0.460122699,0.503916449,0.487804878,0.515981735,0.432098765
182,188,208,107,101,81,0.043956044,0.031914894,0.038461538,0.028037383,0.04950495,0.037037037
415,427,430,221,209,206,0.265060241,0.393442623,0.395348837,0.515837104,0.267942584,0.262135922
260,284,256,140,116,144,0.034615385,0.024647887,0.0234375,0.014285714,0.034482759,0.034722222
395,400,393,199,194,201,0.344303797,0.4125,0.384223919,0.452261307,0.31443299,0.373134328
333,345,336,174,162,171,0.081081081,0.08115942,0.080357143,0.08045977,0.080246914,0.081871345
331,331,348,174,174,157,0.960725076,0.954682779,0.965517241,0.959770115,0.971264368,0.949044586
160,154,154,74,80,80,0.15625,0.136363636,0.155844156,0.135135135,0.175,0.1375
339,349,338,174,164,175,0.159292035,0.143266476,0.183431953,0.166666667,0.201219512,0.12
436,398,406,184,222,214,0.607798165,0.570351759,0.60591133,0.565217391,0.63963964,0.574766355
239,244,251,128,123,116,0.384937238,0.368852459,0.334661355,0.3203125,0.349593496,0.422413793
318,302,286,135,151,167,0.943396226,0.937086093,0.940559441,0.933333333,0.947019868,0.94011976
301,285,286,135,151,150,0.890365449,0.912280702,0.888111888,0.911111111,0.867549669,0.913333333
387,386,399,199,200,187,0.470284238,0.479274611,0.458646617,0.467336683,0.45,0.49197861
275,269,272,133,139,136,0.963636364,0.970260223,0.963235294,0.969924812,0.956834532,0.970588235
387,386,399,199,200,187,0.069767442,0.080310881,0.050125313,0.060301508,0.04,0.101604278
341,354,341,177,164,177,0.249266862,0.234463277,0.269794721,0.254237288,0.286585366,0.214689266
127,292,195,180,15,112,0.566929134,0.667808219,0.712820513,0.727777778,0.533333333,0.571428571
275,247,272,122,150,125,0.829090909,0.789473684,0.827205882,0.786885246,0.86,0.792
310,293,321,152,169,141,0.287096774,0.245733788,0.289719626,0.25,0.325443787,0.241134752
392,394,382,192,190,202,0.375,0.329949239,0.421465969,0.375,0.468421053,0.287128713
381,330,377,163,214,167,0.249343832,0.281818182,0.25464191,0.288343558,0.228971963,0.275449102
194,176,176,79,97,97,0.06185567,0.068181818,0.056818182,0.063291139,0.051546392,0.072164948
262,223,253,107,146,116,0.629770992,0.596412556,0.632411067,0.598130841,0.657534247,0.594827586
612,375,323,43,280,332,0.985294118,0.978666667,0.965944272,0.88372093,0.978571429,0.990963855
300,288,290,139,151,149,0.503333333,0.534722222,0.472413793,0.503597122,0.443708609,0.563758389
286,259,261,117,144,142,0.447552448,0.501930502,0.521072797,0.58974359,0.465277778,0.429577465
143,447,396,350,46,97,0.706293706,0.673378076,0.661616162,0.66,0.673913043,0.721649485
311,275,344,154,190,121,0.479099678,0.429090909,0.456395349,0.409090909,0.494736842,0.454545455
262,273,261,136,125,137,0.061068702,0.04029304,0.057471264,0.036764706,0.08,0.04379562
527,475,508,228,280,247,0.383301708,0.397894737,0.368110236,0.381578947,0.357142857,0.412955466
264,266,272,137,135,129,0.928030303,0.913533835,0.926470588,0.912408759,0.940740741,0.914728682
365,371,366,186,180,185,0.304109589,0.363881402,0.344262295,0.403225806,0.283333333,0.324324324
285,192,253,80,173,112,0.919298246,0.864583333,0.916996047,0.85,0.947976879,0.875
305,315,302,156,146,159,0.219672131,0.295238095,0.331125828,0.403846154,0.253424658,0.188679245
324,329,315,160,155,169,0.333333333,0.422492401,0.434920635,0.525,0.341935484,0.325443787
324,275,337,144,193,131,0.425925926,0.381818182,0.400593472,0.354166667,0.435233161,0.41221374
301,280,263,121,142,159,0.604651163,0.6,0.608365019,0.603305785,0.612676056,0.597484277
403,367,402,183,219,184,0.789081886,0.817438692,0.830845771,0.863387978,0.803652968,0.77173913
418,352,420,177,243,175,0.83492823,0.792613636,0.838095238,0.796610169,0.868312757,0.788571429
289,294,281,143,138,151,0.294117647,0.431972789,0.441281139,0.58041958,0.297101449,0.291390728
260,284,256,140,116,144,0.184615385,0.176056338,0.203125,0.192857143,0.215517241,0.159722222
411,406,413,204,209,202,0.440389294,0.519704433,0.537530266,0.617647059,0.459330144,0.420792079
330,335,311,158,153,177,0.266666667,0.27761194,0.331189711,0.341772152,0.320261438,0.220338983
335,347,336,174,162,173,0.128358209,0.115273775,0.116071429,0.103448276,0.12962963,0.12716763
399,395,398,197,201,198,0.185463659,0.184810127,0.188442211,0.187817259,0.189054726,0.181818182
387,386,399,199,200,187,0.826873385,0.852331606,0.824561404,0.849246231,0.8,0.855614973
320,320,308,154,154,166,0.1,0.0875,0.12987013,0.116883117,0.142857143,0.060240964
387,386,399,199,200,187,0.211886305,0.212435233,0.180451128,0.180904523,0.18,0.245989305
324,275,337,144,193,131,0.320987654,0.334545455,0.296735905,0.305555556,0.29015544,0.366412214
364,386,382,202,180,184,0.321428571,0.339378238,0.361256545,0.376237624,0.344444444,0.298913043
275,290,271,143,128,147,0.112727273,0.137931034,0.158671587,0.181818182,0.1328125,0.095238095
431,440,437,223,214,217,0.118329466,0.245454545,0.249427918,0.372197309,0.121495327,0.115207373
351,351,342,171,171,180,0.381766382,0.413105413,0.435672515,0.467836257,0.403508772,0.361111111
420,407,421,204,217,203,0.185714286,0.110565111,0.168646081,0.093137255,0.239631336,0.128078818
413,417,422,213,209,204,0.370460048,0.381294964,0.412322275,0.422535211,0.401913876,0.338235294
154,134,130,55,75,79,0.409090909,0.320895522,0.446153846,0.345454545,0.52,0.303797468
356,329,353,163,190,166,0.497191011,0.541033435,0.52407932,0.570552147,0.484210526,0.512048193
396,399,389,196,193,203,0.315656566,0.348370927,0.344473008,0.37755102,0.310880829,0.320197044
311,274,343,153,190,121,0.080385852,0.091240876,0.069970845,0.078431373,0.063157895,0.107438017
382,326,384,164,220,162,0.798429319,0.785276074,0.815104167,0.804878049,0.822727273,0.765432099
470,457,465,226,239,231,0.187234043,0.214442013,0.219354839,0.247787611,0.192468619,0.181818182
466,443,439,208,231,235,0.690987124,0.713318284,0.738041002,0.764423077,0.714285714,0.668085106
324,275,337,144,193,131,0.345679012,0.301818182,0.293768546,0.243055556,0.331606218,0.366412214
272,255,293,138,155,117,0.856617647,0.803921569,0.805460751,0.753623188,0.851612903,0.863247863
304,324,388,204,184,120,0.628289474,0.725308642,0.670103093,0.745098039,0.586956522,0.691666667
407,395,398,193,205,202,0.15970516,0.210126582,0.190954774,0.243523316,0.141463415,0.178217822
430,446,462,239,223,207,0.962790698,0.966367713,0.967532468,0.970711297,0.964125561,0.961352657
349,353,346,175,171,178,0.209169054,0.263456091,0.25433526,0.308571429,0.198830409,0.219101124
563,546,553,268,285,278,0.119005329,0.128205128,0.092224231,0.100746269,0.084210526,0.154676259
467,447,470,225,245,222,0.376873662,0.474272931,0.472340426,0.573333333,0.379591837,0.373873874
426,404,432,205,227,199,0.145539906,0.118811881,0.138888889,0.112195122,0.162995595,0.125628141
395,397,392,197,195,200,0.273417722,0.302267003,0.331632653,0.360406091,0.302564103,0.245
382,326,384,164,220,162,0.298429319,0.31595092,0.3203125,0.341463415,0.304545455,0.290123457
306,312,310,158,152,154,0.918300654,0.955128205,0.919354839,0.955696203,0.881578947,0.954545455
421,407,450,218,232,189,0.3847981,0.341523342,0.428888889,0.389908257,0.465517241,0.285714286
489,483,484,239,245,244,0.36196319,0.362318841,0.396694215,0.39748954,0.395918367,0.327868852
539,329,278,34,244,295,0.979591837,0.963525836,0.967625899,0.852941176,0.983606557,0.976271186
307,298,321,156,165,142,0.791530945,0.808724832,0.797507788,0.814102564,0.781818182,0.802816901
493,450,481,219,262,231,0.413793103,0.395555556,0.428274428,0.410958904,0.442748092,0.380952381
492,443,473,212,261,231,0.953252033,0.934537246,0.957716702,0.938679245,0.973180077,0.930735931
388,392,386,195,191,197,0.355670103,0.387755102,0.414507772,0.446153846,0.382198953,0.329949239
391,385,382,188,194,197,0.212276215,0.176623377,0.222513089,0.186170213,0.257731959,0.16751269
389,377,386,187,199,190,0.110539846,0.106100796,0.111398964,0.106951872,0.115577889,0.105263158
433,426,431,212,219,214,0.498845266,0.535211268,0.556844548,0.594339623,0.520547945,0.476635514
426,404,432,205,227,199,0.373239437,0.415841584,0.381944444,0.424390244,0.343612335,0.407035176
385,386,385,193,192,193,0.231168831,0.207253886,0.225974026,0.202072539,0.25,0.212435233
403,405,402,202,200,203,0.086848635,0.096296296,0.089552239,0.099009901,0.08,0.093596059
515,491,438,207,231,284,0.211650485,0.258655804,0.255707763,0.314009662,0.203463203,0.218309859
404,403,401,200,201,203,0.373762376,0.46898263,0.503740648,0.6,0.407960199,0.339901478
351,351,344,172,172,179,0.304843305,0.299145299,0.279069767,0.273255814,0.284883721,0.324022346
447,444,469,233,236,211,0.37360179,0.394144144,0.456289979,0.47639485,0.436440678,0.303317536
468,377,453,181,272,196,0.217948718,0.233421751,0.225165563,0.243093923,0.213235294,0.224489796
382,406,408,216,192,190,0.602094241,0.645320197,0.661764706,0.699074074,0.619791667,0.584210526
457,443,448,217,231,226,0.304157549,0.293453725,0.310267857,0.299539171,0.32034632,0.287610619
339,346,343,175,168,171,0.076696165,0.078034682,0.084548105,0.085714286,0.083333333,0.070175439
373,352,367,173,194,179,0.061662198,0.059659091,0.065395095,0.063583815,0.067010309,0.055865922
431,417,418,202,216,215,0.122969838,0.153477218,0.131578947,0.163366337,0.101851852,0.144186047
387,389,382,192,190,197,0.335917313,0.383033419,0.384816754,0.432291667,0.336842105,0.335025381
435,430,425,210,215,220,0.344827586,0.423255814,0.442352941,0.523809524,0.362790698,0.327272727
496,470,476,225,251,245,0.239919355,0.268085106,0.271008403,0.302222222,0.243027888,0.236734694
396,455,419,239,180,216,0.47979798,0.602197802,0.582338902,0.686192469,0.444444444,0.509259259
469,454,461,223,238,231,0.119402985,0.204845815,0.214750542,0.304932735,0.130252101,0.108225108
501,488,495,241,254,247,0.157684631,0.139344262,0.163636364,0.145228216,0.181102362,0.133603239
504,476,434,203,231,273,0.168650794,0.222689076,0.218894009,0.285714286,0.16017316,0.175824176
469,442,477,225,252,217,0.955223881,0.966063348,0.970649895,0.982222222,0.96031746,0.949308756
403,403,400,200,200,203,0.23325062,0.307692308,0.295,0.37,0.22,0.246305419
487,453,426,196,230,257,0.328542094,0.392935982,0.408450704,0.489795918,0.339130435,0.319066148
436,398,406,184,222,214,0.25,0.221105528,0.229064039,0.195652174,0.256756757,0.242990654
526,486,542,251,291,235,0.581749049,0.617283951,0.557195572,0.589641434,0.529209622,0.646808511
490,478,492,240,252,238,0.314285714,0.353556485,0.367886179,0.408333333,0.329365079,0.298319328
464,449,465,225,240,224,0.474137931,0.514476615,0.548387097,0.591111111,0.508333333,0.4375
455,450,483,239,244,211,0.021978022,0.022222222,0.037267081,0.037656904,0.036885246,0.004739336
503,487,494,239,255,248,0.143141153,0.112936345,0.139676113,0.108786611,0.168627451,0.116935484
450,438,448,218,230,220,0.113333333,0.134703196,0.138392857,0.160550459,0.117391304,0.109090909
402,406,404,204,200,202,0.256218905,0.362068966,0.366336634,0.470588235,0.26,0.252475248
406,409,403,203,200,206,0.270935961,0.359413203,0.349875931,0.438423645,0.26,0.281553398
626,623,631,314,317,309,0.35942492,0.353130016,0.35340729,0.347133758,0.359621451,0.359223301
395,404,357,183,174,221,0.650632911,0.678217822,0.691876751,0.721311475,0.66091954,0.642533937
397,344,395,171,224,173,0.335012594,0.354651163,0.336708861,0.356725146,0.321428571,0.352601156
443,431,432,210,222,221,0.14221219,0.208816705,0.224537037,0.295238095,0.157657658,0.126696833
508,484,522,249,273,235,0.303149606,0.295454545,0.335249042,0.329317269,0.340659341,0.259574468
567,549,556,269,287,280,0.0670194,0.080145719,0.068345324,0.081784387,0.055749129,0.078571429
455,450,483,239,244,211,0.397802198,0.468888889,0.443064182,0.510460251,0.37704918,0.421800948
463,449,452,219,233,230,0.410367171,0.474387528,0.524336283,0.593607306,0.459227468,0.360869565
562,547,553,269,284,278,0.039145907,0.029250457,0.021699819,0.011152416,0.031690141,0.04676259
485,470,487,236,251,234,0.230927835,0.221276596,0.221765914,0.211864407,0.231075697,0.230769231
487,475,482,235,247,240,0.151950719,0.132631579,0.159751037,0.140425532,0.178137652,0.125
405,409,404,204,200,205,0.333333333,0.354523227,0.376237624,0.397058824,0.355,0.312195122
501,483,494,238,256,245,0.203592814,0.180124224,0.21659919,0.193277311,0.23828125,0.167346939
492,443,473,212,261,231,0.981707317,0.979683973,0.987315011,0.985849057,0.988505747,0.974025974
530,502,494,233,261,269,0.335849057,0.336653386,0.382591093,0.386266094,0.379310345,0.293680297
458,464,450,228,222,236,0.395196507,0.398706897,0.444444444,0.447368421,0.441441441,0.351694915
457,408,461,206,255,202,0.971553611,0.970588235,0.976138829,0.975728155,0.976470588,0.965346535
457,458,493,247,246,211,0.95404814,0.938864629,0.93306288,0.91902834,0.947154472,0.962085308
455,450,483,239,244,211,0.751648352,0.713333333,0.739130435,0.70292887,0.774590164,0.725118483
466,443,439,208,231,235,0.100858369,0.115124153,0.109339408,0.125,0.095238095,0.106382979
443,427,428,206,222,221,0.275395034,0.269320843,0.254672897,0.247572816,0.261261261,0.28959276
314,302,340,164,176,138,0.78343949,0.738410596,0.732352941,0.68902439,0.772727273,0.797101449
566,547,557,269,288,278,0.090106007,0.089579525,0.064631957,0.063197026,0.065972222,0.115107914
563,545,554,268,286,277,0.124333925,0.137614679,0.099277978,0.111940299,0.087412587,0.162454874
563,545,556,269,287,276,0.06749556,0.066055046,0.050359712,0.048327138,0.052264808,0.083333333
491,477,486,236,250,241,0.138492872,0.15932914,0.193415638,0.216101695,0.172,0.10373444
557,542,551,268,283,274,0.019748654,0.011070111,0.016333938,0.007462687,0.024734982,0.01459854
496,483,489,238,251,245,0.276209677,0.260869565,0.312883436,0.298319328,0.326693227,0.224489796
559,541,554,268,286,273,0.13059034,0.138632163,0.119133574,0.126865672,0.111888112,0.15018315
560,543,553,268,285,275,0.035714286,0.033149171,0.036166365,0.03358209,0.038596491,0.032727273
497,471,482,228,254,243,0.142857143,0.197452229,0.219917012,0.280701754,0.165354331,0.119341564
490,476,486,236,250,240,0.095918367,0.067226891,0.104938272,0.076271186,0.132,0.058333333
518,496,504,241,263,255,0.353281853,0.387096774,0.410714286,0.44813278,0.376425856,0.329411765
552,539,549,268,281,271,0.041666667,0.051948052,0.038251366,0.048507463,0.028469751,0.055350554
563,542,557,268,289,274,0.005328597,0.009225092,0.007181329,0.01119403,0.003460208,0.00729927
497,482,489,237,252,245,0.424547284,0.435684647,0.419222904,0.430379747,0.408730159,0.440816327
406,405,407,203,204,202,0.435960591,0.511111111,0.530712531,0.60591133,0.455882353,0.415841584
568,549,557,269,288,280,0.070422535,0.0856102,0.073608618,0.089219331,0.059027778,0.082142857
498,483,495,240,255,243,0.463855422,0.482401656,0.456565657,0.475,0.439215686,0.489711934
567,551,558,271,287,280,0.005291005,0.003629764,0.005376344,0.003690037,0.006968641,0.003571429
563,542,553,266,287,276,0.010657194,0.003690037,0.01084991,0.003759398,0.017421603,0.003623188
567,545,554,266,288,279,0.017636684,0.00733945,0.018050542,0.007518797,0.027777778,0.007168459
565,547,556,269,287,278,0.008849558,0.009140768,0.003597122,0.003717472,0.003484321,0.014388489
520,472,458,205,253,267,0.428846154,0.495762712,0.478165939,0.56097561,0.411067194,0.445692884
382,396,392,203,189,193,0.685863874,0.724747475,0.732142857,0.768472906,0.693121693,0.678756477
558,541,551,267,284,274,0.039426523,0.051756007,0.029038113,0.041198502,0.017605634,0.062043796
492,443,473,212,261,231,0.829268293,0.873589165,0.843551797,0.891509434,0.804597701,0.857142857
560,546,550,268,282,278,0.067857143,0.06959707,0.047272727,0.048507463,0.046099291,0.089928058
551,531,542,261,281,270,0.025408348,0.026365348,0.033210332,0.034482759,0.03202847,0.018518519
451,444,437,215,222,229,0.529933481,0.581081081,0.578947368,0.63255814,0.527027027,0.532751092
500,486,498,242,256,244,0.238,0.201646091,0.226907631,0.190082645,0.26171875,0.213114754
533,539,510,258,252,281,0.969981238,0.966604824,0.964705882,0.96124031,0.968253968,0.971530249
465,460,465,230,235,230,0.090322581,0.093478261,0.12688172,0.130434783,0.123404255,0.056521739
561,545,556,270,286,275,0.037433155,0.018348624,0.026978417,0.007407407,0.045454545,0.029090909
455,450,483,239,244,211,0.338461538,0.368888889,0.351966874,0.380753138,0.323770492,0.355450237
537,508,475,223,252,285,0.238361266,0.261811024,0.275789474,0.304932735,0.25,0.228070175
555,540,549,267,282,273,0.073873874,0.07037037,0.067395264,0.063670412,0.070921986,0.076923077
529,494,469,217,252,277,0.304347826,0.380566802,0.360341151,0.451612903,0.281746032,0.324909747
521,513,498,245,253,268,0.239923225,0.325536062,0.333333333,0.424489796,0.245059289,0.235074627
516,495,507,243,264,252,0.162790698,0.131313131,0.175542406,0.144032922,0.204545455,0.119047619
526,486,542,251,291,235,0.47148289,0.487654321,0.503690037,0.521912351,0.487972509,0.45106383
552,532,548,264,284,268,0.072463768,0.071428571,0.065693431,0.064393939,0.066901408,0.078358209
562,557,511,253,258,304,0.231316726,0.31059246,0.30332681,0.391304348,0.217054264,0.243421053
709,673,670,317,353,356,0.430183357,0.509658247,0.513432836,0.602523659,0.433427762,0.426966292
568,551,559,271,288,280,0.007042254,0.007259528,0.003577818,0.003690037,0.003472222,0.010714286
542,527,549,267,282,260,0.398523985,0.426944972,0.4571949,0.486891386,0.429078014,0.365384615
649,605,622,289,333,316,0.394453005,0.456198347,0.511254019,0.584775087,0.447447447,0.338607595
435,448,449,231,218,217,0.151724138,0.265625,0.251670379,0.359307359,0.137614679,0.165898618
564,547,555,269,286,278,0.008865248,0.007312614,0.005405405,0.003717472,0.006993007,0.010791367
565,547,558,270,288,277,0.086725664,0.074954296,0.068100358,0.055555556,0.079861111,0.093862816
525,508,501,242,259,266,0.413333333,0.464566929,0.473053892,0.52892562,0.420849421,0.406015038
564,521,513,235,278,286,0.143617021,0.153550864,0.130604288,0.140425532,0.122302158,0.164335664
530,519,497,243,254,276,0.324528302,0.447013487,0.45472837,0.588477366,0.326771654,0.322463768
552,533,545,263,282,270,0.018115942,0.022514071,0.025688073,0.030418251,0.021276596,0.014814815
568,550,560,271,289,279,0.11443662,0.12,0.101785714,0.10701107,0.096885813,0.132616487
563,539,554,265,289,274,0.014209591,0.012987013,0.009025271,0.00754717,0.010380623,0.018248175
568,549,559,270,289,279,0.014084507,0.009107468,0.008944544,0.003703704,0.01384083,0.014336918
477,457,474,227,247,230,0.903563941,0.921225383,0.902953586,0.920704846,0.886639676,0.92173913
562,545,555,269,286,276,0.03202847,0.023853211,0.012612613,0.003717472,0.020979021,0.043478261
566,551,557,271,286,280,0.107773852,0.105263158,0.095152603,0.092250923,0.097902098,0.117857143
567,547,556,268,288,279,0.065255732,0.073126143,0.06294964,0.070895522,0.055555556,0.075268817
568,549,557,269,288,280,0.042253521,0.067395264,0.037701975,0.063197026,0.013888889,0.071428571
567,548,557,269,288,279,0.0335097,0.02189781,0.034111311,0.022304833,0.045138889,0.021505376
521,500,513,246,267,254,0.165067179,0.148,0.191033138,0.174796748,0.205992509,0.122047244
569,551,560,271,289,280,0.017574692,0.014519056,0.010714286,0.007380074,0.01384083,0.021428571
564,545,555,268,287,277,0.117021277,0.128440367,0.093693694,0.104477612,0.083623693,0.151624549
565,547,558,270,288,277,0.012389381,0.012797075,0.003584229,0.003703704,0.003472222,0.02166065
510,482,494,233,261,249,0.135294118,0.143153527,0.129554656,0.137339056,0.122605364,0.148594378
498,484,494,240,254,244,0.058232932,0.053719008,0.058704453,0.054166667,0.062992126,0.053278689
565,546,557,269,288,277,0.031858407,0.021978022,0.028725314,0.018587361,0.038194444,0.025270758
567,550,557,270,287,280,0.017636684,0.025454545,0.017953321,0.025925926,0.010452962,0.025
616,588,580,276,304,312,0.480519481,0.50170068,0.539655172,0.565217391,0.516447368,0.445512821
567,550,559,271,288,279,0.100529101,0.101818182,0.073345259,0.073800738,0.072916667,0.129032258
559,542,555,269,286,273,0.010733453,0.011070111,0.018018018,0.018587361,0.017482517,0.003663004
553,536,549,266,283,270,0.072332731,0.074626866,0.069216758,0.071428571,0.067137809,0.077777778
640,605,607,286,321,319,0.3515625,0.348760331,0.398682043,0.398601399,0.398753894,0.304075235
499,489,492,241,251,248,0.304609218,0.298568507,0.337398374,0.331950207,0.342629482,0.266129032
567,548,559,270,289,278,0.010582011,0.020072993,0.012522361,0.022222222,0.003460208,0.017985612
492,443,473,212,261,231,0.743902439,0.799097065,0.761099366,0.820754717,0.712643678,0.779220779
675,657,644,313,331,344,0.721481481,0.736681887,0.76242236,0.779552716,0.746223565,0.697674419
565,549,554,269,285,280,0.044247788,0.038251366,0.032490975,0.026022305,0.038596491,0.05
626,623,631,314,317,309,0.378594249,0.364365971,0.383518225,0.369426752,0.397476341,0.359223301
697,644,631,289,342,355,0.308464849,0.378881988,0.388272583,0.474048443,0.315789474,0.301408451
559,537,576,277,299,260,0.457960644,0.506517691,0.552083333,0.602888087,0.505016722,0.403846154
644,599,593,274,319,325,0.222049689,0.303839733,0.28836425,0.383211679,0.206896552,0.236923077
637,597,586,273,313,324,0.177394035,0.256281407,0.262798635,0.355311355,0.182108626,0.172839506
567,550,559,271,288,279,0.029982363,0.027272727,0.02862254,0.025830258,0.03125,0.028673835
560,542,554,268,286,274,0.0375,0.036900369,0.034296029,0.03358209,0.034965035,0.040145985
561,547,556,271,285,276,0.057040998,0.054844607,0.032374101,0.029520295,0.035087719,0.079710145
567,548,559,270,289,278,0.065255732,0.065693431,0.048300537,0.048148148,0.048442907,0.082733813
563,546,557,270,287,276,0.072824156,0.076923077,0.059245961,0.062962963,0.055749129,0.09057971
567,546,557,268,289,278,0.088183422,0.080586081,0.068222621,0.059701493,0.076124567,0.100719424
568,548,558,269,289,279,0.091549296,0.089416058,0.073476703,0.07063197,0.076124567,0.107526882
554,530,544,260,284,270,0.09566787,0.098113208,0.079044118,0.080769231,0.077464789,0.114814815
566,549,557,270,287,279,0.077738516,0.072859745,0.053859964,0.048148148,0.059233449,0.096774194
622,560,614,276,338,284,0.019292605,0.032142857,0.026058632,0.039855072,0.014792899,0.024647887
503,489,498,242,256,247,0.296222664,0.27607362,0.281124498,0.260330579,0.30078125,0.291497976
492,450,428,193,235,257,0.032520325,0.055555556,0.058411215,0.088082902,0.034042553,0.031128405
557,542,551,268,283,274,0.061041293,0.035055351,0.030852995,0.003731343,0.056537102,0.065693431
567,549,558,270,288,279,0.088183422,0.080145719,0.05734767,0.048148148,0.065972222,0.111111111
566,549,557,270,287,279,0.024734982,0.018214936,0.017953321,0.011111111,0.024390244,0.025089606
552,537,549,267,282,270,0.010869565,0.018621974,0.010928962,0.018726592,0.003546099,0.018518519
590,548,538,248,290,300,0.271186441,0.288321168,0.312267658,0.334677419,0.293103448,0.25
675,586,653,282,371,304,0.265185185,0.259385666,0.274119449,0.269503546,0.277628032,0.25
551,527,540,258,282,269,0.090744102,0.096774194,0.087037037,0.093023256,0.081560284,0.100371747
620,586,590,278,312,308,0.198387097,0.255972696,0.249152542,0.31294964,0.192307692,0.204545455
734,568,720,277,443,291,0.957765668,0.955985915,0.955555556,0.953068592,0.957110609,0.958762887
568,550,560,271,289,279,0.065140845,0.063636364,0.042857143,0.040590406,0.044982699,0.086021505
563,546,555,269,286,277,0.047957371,0.036630037,0.030630631,0.018587361,0.041958042,0.054151625
568,545,553,265,288,280,0.040492958,0.036697248,0.056057866,0.052830189,0.059027778,0.021428571
778,796,840,429,411,367,0.5218509,0.533919598,0.527380952,0.538461538,0.515815085,0.528610354
734,568,720,277,443,291,0.957765668,0.954225352,0.9625,0.960288809,0.963882619,0.948453608
569,551,560,271,289,280,0.024604569,0.01814882,0.021428571,0.014760148,0.027681661,0.021428571
665,625,608,284,324,341,0.469172932,0.4528,0.472039474,0.454225352,0.487654321,0.451612903
564,547,555,269,286,278,0.021276596,0.020109689,0.012612613,0.011152416,0.013986014,0.028776978
636,598,584,273,311,325,0.31918239,0.301003344,0.279109589,0.256410256,0.29903537,0.338461538
634,606,598,285,313,321,0.323343849,0.336633663,0.329431438,0.343859649,0.31629393,0.330218069
560,543,553,268,285,275,0.035714286,0.031307551,0.023508137,0.018656716,0.028070175,0.043636364
561,545,552,268,284,277,0.10516934,0.108256881,0.076086957,0.078358209,0.073943662,0.137184116
692,637,637,291,346,346,0.596820809,0.642072214,0.659340659,0.714776632,0.612716763,0.580924855
569,550,559,270,289,280,0.012302285,0.010909091,0.005366726,0.003703704,0.006920415,0.017857143
614,581,581,274,307,307,0.460912052,0.524956971,0.547332186,0.620437956,0.482084691,0.439739414
685,670,723,354,369,316,0.01459854,0.011940299,0.008298755,0.005649718,0.010840108,0.018987342
568,548,558,269,289,279,0.066901408,0.080291971,0.071684588,0.085501859,0.058823529,0.075268817
1107,993,1094,490,604,503,0.215898826,0.254783484,0.217550274,0.257142857,0.185430464,0.252485089
556,539,545,264,281,275,0.019784173,0.020408163,0.018348624,0.018939394,0.017793594,0.021818182
558,541,549,266,283,275,0.073476703,0.075785582,0.054644809,0.056390977,0.053003534,0.094545455
713,680,677,322,355,358,0.485273492,0.483823529,0.512555391,0.51242236,0.512676056,0.458100559
566,547,559,270,289,277,0.044169611,0.045703839,0.02862254,0.02962963,0.027681661,0.061371841
722,612,686,288,398,324,0.988919668,0.990196078,0.988338192,0.989583333,0.987437186,0.990740741
616,587,571,271,300,316,0.214285714,0.293015332,0.297723292,0.387453875,0.216666667,0.212025316
826,759,731,332,399,427,0.274818402,0.295125165,0.269493844,0.292168675,0.250626566,0.297423888
695,655,648,304,344,351,0.4,0.427480916,0.453703704,0.486842105,0.424418605,0.376068376
683,642,639,299,340,343,0.629575403,0.665109034,0.668231612,0.7090301,0.632352941,0.626822157
605,589,568,276,292,313,0.474380165,0.505942275,0.512323944,0.547101449,0.479452055,0.469648562
567,550,559,271,288,279,0.044091711,0.065454545,0.041144902,0.062730627,0.020833333,0.068100358
564,547,557,270,287,277,0.026595745,0.023765996,0.017953321,0.014814815,0.020905923,0.032490975
566,549,559,271,288,278,0.003533569,0.005464481,0.005366726,0.007380074,0.003472222,0.003597122
644,597,589,271,318,326,0.321428571,0.353433836,0.336162988,0.372693727,0.305031447,0.337423313
1043,960,1019,468,551,492,0.98274209,0.982291667,0.985279686,0.985042735,0.985480944,0.979674797
639,599,586,273,313,326,0.336463224,0.330550918,0.312286689,0.304029304,0.319488818,0.352760736
651,620,593,281,312,339,0.290322581,0.370967742,0.379426644,0.473309609,0.294871795,0.286135693
785,734,761,355,406,379,0.47133758,0.418256131,0.50065703,0.447887324,0.54679803,0.390501319
623,582,549,254,295,328,0.378812199,0.446735395,0.418943534,0.5,0.349152542,0.405487805
587,566,635,307,328,259,0.778534923,0.793286219,0.787401575,0.801302932,0.774390244,0.783783784
703,610,677,292,385,318,0.253200569,0.260655738,0.273264402,0.284246575,0.264935065,0.238993711
687,608,669,295,374,313,0.844250364,0.856907895,0.859491779,0.874576271,0.847593583,0.840255591
566,549,559,271,288,278,0.010600707,0.007285974,0.007155635,0.003690037,0.010416667,0.010791367
806,711,821,363,458,348,0.249379653,0.265822785,0.287454324,0.308539945,0.270742358,0.221264368
569,551,560,271,289,280,0.075571178,0.085299456,0.067857143,0.077490775,0.058823529,0.092857143
469,448,469,224,245,224,0.200426439,0.200892857,0.179104478,0.178571429,0.179591837,0.223214286
730,689,695,327,368,362,0.568493151,0.561683599,0.592805755,0.587155963,0.597826087,0.538674033
564,546,554,268,286,278,0.015957447,0.018315018,0.016245487,0.018656716,0.013986014,0.017985612
568,548,586,283,303,265,0.445422535,0.452554745,0.486348123,0.494699647,0.478547855,0.40754717
866,789,867,395,472,394,0.840646651,0.839036755,0.837370242,0.835443038,0.838983051,0.842639594
782,683,789,345,444,338,0.047314578,0.060029283,0.060836502,0.075362319,0.04954955,0.044378698
688,602,670,292,378,310,0.347383721,0.333887043,0.355223881,0.342465753,0.365079365,0.325806452
702,628,688,307,381,321,0.856125356,0.891719745,0.864825581,0.90228013,0.834645669,0.881619938
984,878,916,405,511,473,0.994918699,0.990888383,0.992358079,0.987654321,0.996086106,0.993657505
1354,1192,1318,578,740,614,0.281388479,0.276845638,0.252655539,0.243944637,0.259459459,0.30781759
665,635,616,293,323,342,0.278195489,0.407874016,0.402597403,0.549488055,0.269349845,0.286549708
747,726,781,380,401,346,0.429718876,0.44214876,0.43021767,0.442105263,0.418952618,0.442196532
828,755,705,316,389,439,0.971014493,0.966887417,0.964539007,0.958860759,0.969151671,0.972665148
635,594,595,277,318,317,0.634645669,0.614478114,0.645378151,0.624548736,0.663522013,0.605678233
617,573,574,265,309,308,0.259319287,0.260034904,0.277003484,0.279245283,0.275080906,0.243506494
559,538,551,265,286,273,0.019677996,0.014869888,0.016333938,0.011320755,0.020979021,0.018315018
552,546,596,295,301,251,0.565217391,0.58974359,0.570469799,0.593220339,0.548172757,0.585657371
622,547,621,273,348,274,0.557877814,0.548446069,0.558776167,0.549450549,0.566091954,0.547445255
699,608,693,301,392,307,0.852646638,0.827302632,0.844155844,0.817275748,0.864795918,0.83713355
638,774,850,493,357,281,0.648902821,0.749354005,0.755294118,0.819472617,0.666666667,0.62633452
1321,1271,1338,644,694,627,0.756245269,0.756884343,0.752615845,0.75310559,0.752161383,0.76076555
658,625,631,299,332,326,0.247720365,0.2288,0.247226624,0.227424749,0.265060241,0.23006135
1148,1110,1120,541,579,569,0.006968641,0.008108108,0.009821429,0.011090573,0.008635579,0.005272408
798,726,706,317,389,409,0.987468672,0.982093664,0.978753541,0.971608833,0.984575835,0.990220049
696,649,659,306,353,343,0.439655172,0.505392912,0.525037936,0.60130719,0.458923513,0.419825073
938,877,919,429,490,448,0.986140725,0.992018244,0.982589771,0.988344988,0.97755102,0.995535714
627,616,631,310,321,306,0.870813397,0.892857143,0.868462758,0.890322581,0.847352025,0.895424837
722,699,787,382,405,317,0.775623269,0.811158798,0.783989835,0.816753927,0.75308642,0.804416404
804,745,805,373,432,372,0.715174129,0.708724832,0.704347826,0.697050938,0.710648148,0.720430108
967,864,929,413,516,451,0.190279214,0.203703704,0.167922497,0.179176755,0.158914729,0.22616408
1049,1011,1028,495,533,516,0.476644423,0.473788328,0.458171206,0.454545455,0.461538462,0.492248062
1059,940,983,432,551,508,0.257790368,0.246808511,0.267548321,0.256944444,0.275862069,0.238188976
519,867,854,601,253,266,0.691714836,0.785467128,0.789227166,0.828618968,0.695652174,0.687969925
1076,1036,1060,510,550,526,0.402416357,0.411196911,0.397169811,0.405882353,0.389090909,0.41634981
1059,940,983,432,551,508,0.248347498,0.262765957,0.270600203,0.289351852,0.255898367,0.24015748
1481,1326,1435,640,795,686,0.640783255,0.660633484,0.654355401,0.6765625,0.636477987,0.645772595
695,655,652,306,346,349,0.214388489,0.201526718,0.234662577,0.222222222,0.24566474,0.183381089
738,696,722,340,382,356,0.350948509,0.336206897,0.397506925,0.385294118,0.408376963,0.289325843
1356,1269,1379,646,733,623,0.080383481,0.070921986,0.076142132,0.066563467,0.084583902,0.075441413
641,619,606,292,314,327,0.372854914,0.462035541,0.47029703,0.568493151,0.378980892,0.366972477
1031,899,1040,454,586,445,0.782735209,0.760845384,0.760576923,0.735682819,0.779863481,0.786516854
861,780,907,413,494,367,0.701509872,0.674358974,0.676957001,0.648910412,0.700404858,0.702997275
797,700,811,357,454,343,0.230865747,0.221428571,0.218249075,0.207282913,0.226872247,0.236151603
854,818,880,422,458,396,0.710772834,0.710268949,0.697727273,0.696682464,0.698689956,0.724747475
909,859,966,458,508,401,0.249724972,0.277066356,0.288819876,0.316593886,0.263779528,0.2319202
846,834,822,405,417,429,0.124113475,0.128297362,0.116788321,0.120987654,0.112709832,0.135198135
1149,1103,1162,558,604,545,0.744995648,0.745240254,0.743545611,0.743727599,0.743377483,0.746788991
1037,894,987,422,565,472,0.18997107,0.182326622,0.174265451,0.163507109,0.182300885,0.199152542
1092,961,1115,492,623,469,0.271062271,0.284079084,0.289686099,0.304878049,0.277688604,0.262260128
1040,965,1061,493,568,472,0.731730769,0.717098446,0.737983035,0.724137931,0.75,0.709745763
1404,1362,1418,688,730,674,0.634615385,0.646108664,0.659379408,0.671511628,0.647945205,0.620178042
684,610,682,304,378,306,0.73245614,0.754098361,0.752199413,0.776315789,0.732804233,0.732026144
1092,961,1115,492,623,469,0.388278388,0.415192508,0.429596413,0.461382114,0.404494382,0.36673774
698,655,677,317,360,338,0.411174785,0.419847328,0.431314623,0.441640379,0.422222222,0.399408284
1512,1348,1522,679,843,669,0.095899471,0.087537092,0.091327201,0.082474227,0.098457888,0.092675635
1154,1020,1152,509,643,511,0.256499133,0.296078431,0.276041667,0.31827112,0.242612753,0.273972603
1137,1090,1153,553,600,537,0.617414248,0.644036697,0.640069384,0.667269439,0.615,0.620111732
1197,1053,1206,531,675,522,0.242272348,0.242165242,0.224709784,0.222222222,0.226666667,0.262452107
1287,1096,1263,536,727,560,0.296814297,0.269160584,0.277909739,0.246268657,0.301237964,0.291071429
896,801,851,378,473,423,0.508928571,0.538077403,0.518213866,0.55026455,0.492600423,0.527186761
1025,908,999,441,558,467,0.989268293,0.984581498,0.986986987,0.98185941,0.991039427,0.987152034
1617,1375,1594,676,918,699,0.036487322,0.038545455,0.036386449,0.038461538,0.034858388,0.038626609
267,479,482,347,135,132,0.172284644,0.467640919,0.497925311,0.602305476,0.22962963,0.113636364
1171,999,1188,508,680,491,0.961571307,0.967967968,0.968855219,0.976377953,0.963235294,0.959266802
1393,1304,1305,608,697,696,0.497487437,0.525306748,0.502681992,0.532894737,0.476327116,0.518678161
1400,1266,1432,649,783,617,0.587857143,0.578988942,0.582402235,0.573189522,0.590038314,0.585089141
1423,1324,1371,636,735,688,0.806746311,0.817975831,0.795769511,0.806603774,0.786394558,0.828488372
593,570,621,299,322,271,0.276559865,0.287719298,0.286634461,0.297658863,0.276397516,0.276752768
555,717,752,457,295,260,0.963963964,0.966527197,0.968085106,0.969365427,0.966101695,0.961538462
1655,1483,1618,723,895,760,0.160120846,0.169251517,0.159456119,0.168741355,0.151955307,0.169736842
1442,1386,1468,706,762,680,0.8370319,0.836219336,0.835149864,0.83427762,0.835958005,0.838235294
649,741,766,429,337,312,0.969183359,0.968960864,0.96997389,0.96969697,0.970326409,0.967948718
1493,1336,1467,655,812,681,0.575351641,0.601047904,0.608043626,0.638167939,0.583743842,0.565345081
1519,1418,1529,714,815,704,0.978275181,0.976022567,0.975801177,0.973389356,0.97791411,0.978693182
1333,1300,1703,835,868,465,0.703675919,0.663846154,0.699354081,0.668263473,0.729262673,0.655913978
1426,1299,1487,680,807,619,0.267882188,0.224018476,0.248150639,0.204411765,0.285006196,0.245557351
1629,1430,1653,727,926,703,0.220380602,0.226573427,0.224440411,0.231086657,0.219222462,0.221906117
477,647,642,406,236,241,0.1278826,0.292117465,0.31152648,0.403940887,0.152542373,0.10373444
1524,1454,1494,712,782,742,0.961942257,0.961485557,0.961178046,0.960674157,0.961636829,0.962264151
1300,1149,1337,593,744,556,0.54,0.550043516,0.526551982,0.534569983,0.52016129,0.566546763
2112,1933,2169,995,1174,938,0.00094697,0.001551992,0.001383126,0.00201005,0.000851789,0.001066098
1432,1292,1394,627,767,665,0.833798883,0.811145511,0.830703013,0.807017544,0.850065189,0.815037594
1325,1191,1354,610,744,581,0.634716981,0.6263644,0.640324963,0.632786885,0.646505376,0.619621343
1767,1688,1723,822,901,866,0.049801924,0.046800948,0.060940221,0.058394161,0.063263041,0.035796767
1726,1569,1677,760,917,809,0.259559676,0.264499681,0.276088253,0.282894737,0.27044711,0.247218789
1679,1483,1678,741,937,742,0.200119119,0.203641268,0.194278903,0.197031039,0.192102455,0.210242588
1966,1735,1933,851,1082,884,0.035096643,0.038040346,0.03569581,0.038777908,0.033271719,0.037330317
1468,1318,1420,635,785,683,0.897820163,0.882397572,0.899295775,0.883464567,0.912101911,0.881405564
1185,1057,1194,533,661,524,0.637974684,0.634815516,0.654103853,0.652908068,0.655068079,0.616412214
1058,1020,1074,518,556,502,0.435727788,0.458823529,0.444134078,0.467181467,0.422661871,0.450199203
601,549,630,289,341,260,0.404326123,0.386156648,0.404761905,0.387543253,0.419354839,0.384615385
2257,1970,2215,964,1251,1006,0.906956136,0.925888325,0.906997743,0.926348548,0.892086331,0.925447316
1941,1639,1938,818,1120,821,0.719216899,0.729103112,0.722910217,0.733496333,0.715178571,0.724725944
2730,2546,2838,1327,1511,1219,0.988278388,0.990573449,0.988724454,0.990957046,0.986763733,0.990155865
1249,1192,1397,670,727,522,0.710168135,0.715604027,0.720114531,0.725373134,0.715268226,0.703065134
1523,1412,1655,772,883,640,0.739330269,0.733711048,0.725075529,0.718911917,0.730464326,0.7515625
1609,1452,1499,671,828,781,0.880671224,0.893939394,0.866577718,0.87928465,0.856280193,0.90653009
1700,1508,1680,744,936,764,0.323529412,0.317639257,0.306547619,0.298387097,0.313034188,0.336387435
1468,1316,1414,631,783,685,0.449591281,0.465045593,0.471004243,0.489698891,0.455938697,0.442335766
1949,1836,1837,862,975,974,0.525910723,0.540849673,0.532389766,0.548723898,0.517948718,0.533880903
1417,1278,1437,649,788,629,0.671136203,0.67057903,0.679192763,0.679506934,0.67893401,0.66136725
1782,1729,2125,1036,1089,693,0.751964085,0.716020821,0.730352941,0.69980695,0.759412305,0.74025974
1519,1419,1530,715,815,704,0.953917051,0.946441156,0.946405229,0.938461538,0.953374233,0.954545455
2275,1989,2234,974,1260,1015,0.683956044,0.687782805,0.675022381,0.67761807,0.673015873,0.697536946
3171,3023,3180,1516,1664,1507,0.020813623,0.018524644,0.02327044,0.021108179,0.025240385,0.01592568
2017,1788,2107,939,1168,849,0.249876054,0.254474273,0.252966303,0.25772098,0.249143836,0.250883392
2263,2109,2254,1050,1204,1059,0.557666814,0.569938359,0.559006211,0.571428571,0.548172757,0.568460812
2689,2588,2785,1342,1443,1246,0.149497955,0.147217929,0.136086176,0.13338301,0.138600139,0.16211878
3045,2542,3071,1284,1787,1258,0.358949097,0.337529504,0.359166395,0.338006231,0.374370453,0.337042925
2411,2007,2354,975,1379,1032,0.600165906,0.59840558,0.600679694,0.598974359,0.601885424,0.597868217
1899,1930,2005,1018,987,912,0.473933649,0.465284974,0.446882793,0.439096267,0.45491388,0.494517544
2206,1982,2262,1019,1243,963,0.395738894,0.428859738,0.397435897,0.42983317,0.370876911,0.427829699
3086,2661,3139,1357,1782,1304,0.042449773,0.05787298,0.051927365,0.06853353,0.039281706,0.046779141
2902,2798,3288,1592,1696,1206,0.810475534,0.82880629,0.819038929,0.835427136,0.80365566,0.820066335
2708,2466,2684,1221,1463,1245,0.194608567,0.197080292,0.202309985,0.205569206,0.199589884,0.18875502
2932,2748,2834,1325,1509,1423,0.11834925,0.112081514,0.121736062,0.115471698,0.127236581,0.108924807
3634,3632,4376,2187,2189,1445,0.018161805,0.01404185,0.015310786,0.011888432,0.018730014,0.017301038
2587,2442,2675,1265,1410,1177,0.084267491,0.08026208,0.086728972,0.083003953,0.090070922,0.077315208
2737,2428,2633,1162,1471,1266,0.482645232,0.502883031,0.493733384,0.516351119,0.475866757,0.490521327
2256,1976,2202,961,1241,1015,0.887411348,0.901821862,0.887375114,0.902185224,0.875906527,0.901477833
2200,1851,2259,955,1304,896,0.324090909,0.372771475,0.344842851,0.395811518,0.307515337,0.348214286
4088,3460,4034,1703,2331,1757,0.723336595,0.731791908,0.70872583,0.714621257,0.704418704,0.748434832
2259,2038,2263,1021,1242,1017,0.274457725,0.286555447,0.266902342,0.278158668,0.257648953,0.294985251
4005,4030,4677,2351,2326,1679,0.039450687,0.026054591,0.036134274,0.024670353,0.04772141,0.027992853
3057,2869,3016,1414,1602,1455,0.309780831,0.308818404,0.294098143,0.292079208,0.29588015,0.325085911
2707,2465,2808,1283,1525,1182,0.324344293,0.301419878,0.318019943,0.295401403,0.33704918,0.307952623
2699,2513,2796,1305,1491,1208,0.235642831,0.262236371,0.260014306,0.287356322,0.236083166,0.235099338
7574,6905,6957,3144,3813,3761,0.001716398,0.001593049,0.002299842,0.002226463,0.002360346,0.001063547
3003,2625,3010,1316,1694,1309,0.316017316,0.310095238,0.312624585,0.306231003,0.317591499,0.313980138
3505,3219,3488,1601,1887,1618,0.927817404,0.926374651,0.92087156,0.91880075,0.922628511,0.933868974
4623,4035,4530,1971,2559,2064,0.609560891,0.598513011,0.601103753,0.588533739,0.610785463,0.608042636
4318,4120,4510,2156,2354,1964,0.439092172,0.456553398,0.440576497,0.457328386,0.425233645,0.455702648
2482,2172,2486,1088,1398,1084,0.452054795,0.425414365,0.442477876,0.414522059,0.464234621,0.436346863
2578,2344,2566,1166,1400,1178,0.275407292,0.259385666,0.266562744,0.249571184,0.280714286,0.26910017
3736,3313,3801,1689,2112,1624,0.042291221,0.043766979,0.043409629,0.04499704,0.042140152,0.042487685
2860,2595,2977,1356,1621,1239,0.291608392,0.288631985,0.308028216,0.306784661,0.309068476,0.268765133
7555,6377,7612,3217,4395,3160,0.023031105,0.023522032,0.021019443,0.021137706,0.020932878,0.025949367
5123,4531,5224,2316,2908,2215,0.101503026,0.099536526,0.1012634,0.099309154,0.102819807,0.099774266
2344,2099,2319,1037,1282,1062,0.925767918,0.930443068,0.930142303,0.93539055,0.925897036,0.925612053
6180,5472,6140,2716,3424,2756,0.089805825,0.107090643,0.100162866,0.11892489,0.085280374,0.095428157
4205,3516,4259,1785,2474,1731,0.468489893,0.479806598,0.456210378,0.464985994,0.449878739,0.495089544
5064,4345,5081,2181,2900,2164,0.215837283,0.213578826,0.222200354,0.220999541,0.223103448,0.206099815
6125,5270,6133,2639,3494,2631,0.091918367,0.100948767,0.0940812,0.103448276,0.087006297,0.098441657
9075,7849,9348,4061,5287,3788,0.002975207,0.002293286,0.002460419,0.001723713,0.003026291,0.002903907
6626,6092,6652,3059,3593,3033,0.15197706,0.14986868,0.151533373,0.149395227,0.153353743,0.150346192
4869,4267,4928,2163,2765,2104,0.501745738,0.540192172,0.496347403,0.533518262,0.467269439,0.547053232
6976,6666,6976,3333,3643,3333,0.046588303,0.04170417,0.038847477,0.03360336,0.043645347,0.04980498
5930,5268,5842,2590,3252,2678,0.749241147,0.770690964,0.74820267,0.76988417,0.730934809,0.771471247
4182,3804,4450,2036,2414,1768,0.429459589,0.43980021,0.446067416,0.457269155,0.436619718,0.419683258
5814,5125,5891,2601,3290,2524,0.061059512,0.065365854,0.061449669,0.065743945,0.058054711,0.064976228
7347,6772,7521,3473,4048,3299,0.94079216,0.938718252,0.94256083,0.940685286,0.94416996,0.936647469
6559,6053,6410,2952,3458,3101,0.394877268,0.416157277,0.387363495,0.408536585,0.369288606,0.423411803
5163,4433,5174,2222,2952,2211,0.312608948,0.302278367,0.310398145,0.299729973,0.318428184,0.304839439
2697,2481,2682,1233,1449,1248,0.734519837,0.74566707,0.722967934,0.733171127,0.714285714,0.758012821
8937,8093,8728,3942,4786,4151,0.004028197,0.003336216,0.004468378,0.003805175,0.005014626,0.00289087
7187,6716,7189,3359,3830,3357,0.053708084,0.05077427,0.053275838,0.050312593,0.055874674,0.051236223
6575,6378,7023,3413,3610,2965,0.562889734,0.574631546,0.566139826,0.577204805,0.55567867,0.571669477
8717,8220,8763,4133,4630,4087,0.043363543,0.041484185,0.038000685,0.035809339,0.039956803,0.047222902
7720,7240,7624,3572,4052,3668,0.06865285,0.061464088,0.065188877,0.057670773,0.071816387,0.065158124
8618,8059,8661,4051,4610,4008,0.071942446,0.063531456,0.066735943,0.058010368,0.074403471,0.069111776
9318,8785,9317,4392,4925,4393,0.068469629,0.061126921,0.060641838,0.052823315,0.067614213,0.069428636
7089,6317,7082,3155,3927,3162,0.245309635,0.239512427,0.242304434,0.236133122,0.247262541,0.24288425
8899,8391,8974,4233,4741,4158,0.052702551,0.048146824,0.047804769,0.042995511,0.052098713,0.053391053
8739,8264,8713,4119,4594,4145,0.052179883,0.050338819,0.049351544,0.047341588,0.051153679,0.05331725
9154,8866,10242,4977,5265,3889,0.209198165,0.194789082,0.197227104,0.184046614,0.20968661,0.208536899
6097,5263,6192,2679,3513,2584,0.381335083,0.391221737,0.391795866,0.403135498,0.383148306,0.378869969
4457,4014,4699,2128,2571,1886,0.287188692,0.317887394,0.316237497,0.348214286,0.289770517,0.283669141
8839,8447,9832,4720,5112,3727,0.356262021,0.341896531,0.348352319,0.335169492,0.360524257,0.350415884
8686,7954,8720,3994,4726,3960,0.565968225,0.565250189,0.560550459,0.559339009,0.56157427,0.571212121
3795,3453,3862,1760,2102,1693,0.577338603,0.605560382,0.587778353,0.616477273,0.563748811,0.594211459
8704,7495,8569,3680,4889,3815,0.840303309,0.825216811,0.836386976,0.820380435,0.848435263,0.829882045
9113,8752,10213,4926,5287,3826,0.463623395,0.441841865,0.440223245,0.42001624,0.459050501,0.469942499
9141,8609,9156,4312,4844,4297,0.055354994,0.051225462,0.051660114,0.047309833,0.055532618,0.055154759
8905,7988,8749,3916,4833,4072,0.383267827,0.401727591,0.377871757,0.396067416,0.363128492,0.407170923
6623,5970,6809,3078,3731,2892,0.526498566,0.518760469,0.527537083,0.52014295,0.533637095,0.517289073
9030,8631,10003,4802,5201,3829,0.43765227,0.484880083,0.459362191,0.502707205,0.419342434,0.462522852
9502,8929,9505,4466,5039,4463,0.055251526,0.051517527,0.050604945,0.046574116,0.054177416,0.056464262
10863,9827,10952,4958,5994,4869,0.014544785,0.013941182,0.013604821,0.012908431,0.014180848,0.014992812
8713,8315,9584,4593,4991,3722,0.418569953,0.402525556,0.42278798,0.408447638,0.435984773,0.395217625
9333,8094,9241,4001,5240,4093,0.051858995,0.051890289,0.052808138,0.052986753,0.052671756,0.050818471
10625,9184,10491,4525,5966,4659,0.832282353,0.819250871,0.826708607,0.812596685,0.837412001,0.825713672
11006,9706,11146,4923,6223,4783,0.236325641,0.27014218,0.24214965,0.276254316,0.215169532,0.263851139
10573,9432,10727,4793,5934,4639,0.757306346,0.754028838,0.756875175,0.753598999,0.759521402,0.754472947
12513,10896,12921,5652,7269,5244,0.381363382,0.382709251,0.375667518,0.376150035,0.375292337,0.389778795
8897,8235,9112,4225,4887,4010,0.501180173,0.508318154,0.498353819,0.505088757,0.492531205,0.511720698
15605,13829,15466,6845,8621,6984,0.754886254,0.744667004,0.752618647,0.742001461,0.761048602,0.747279496
12212,10966,12088,5421,6667,5545,0.561988208,0.566751778,0.552117803,0.555801513,0.549122544,0.577457169
17943,15659,18014,7865,10149,7794,0.043248063,0.046426975,0.042800044,0.045899555,0.040398069,0.046959199
18531,18139,18592,9100,9492,9039,0.052884356,0.054743922,0.048354131,0.05010989,0.046670881,0.059409227
16575,16361,16690,8238,8452,8123,0.048325792,0.050119186,0.045476333,0.047220199,0.043776621,0.053059215
18579,18239,18660,9160,9500,9079,0.0562463,0.056088601,0.052411576,0.052183406,0.052631579,0.060028638
16931,14657,16644,7185,9459,7472,0.261827417,0.267653681,0.2703677,0.277661795,0.264827149,0.258029979
14869,12851,14972,6477,8495,6374,0.228999933,0.240915104,0.227023778,0.238536359,0.218246027,0.243332287
18603,16163,18366,7963,10403,8200,0.019029189,0.019798305,0.018403572,0.019088283,0.017879458,0.020487805
13797,12816,14033,6526,7507,6290,0.544611147,0.553604869,0.542079384,0.550720196,0.534567737,0.556597774
18271,17890,18287,8953,9334,8937,0.063926441,0.064281722,0.06058949,0.06087345,0.06031712,0.067696095
17485,17067,17516,8549,8967,8518,0.056162425,0.058592606,0.052523407,0.054860218,0.050295528,0.062338577
16963,14881,16828,7373,9455,7508,0.64493309,0.63759156,0.64368909,0.636104706,0.649603384,0.639051678
10708,9361,10675,4664,6011,4697,0.53978334,0.530926183,0.53676815,0.527444254,0.544002662,0.534383649
18080,15321,18009,7625,10384,7696,0.975774336,0.97585014,0.974012994,0.973770492,0.974191063,0.977910603
17420,17017,17495,8546,8949,8471,0.052123995,0.054474937,0.05138611,0.053709338,0.049167505,0.055247314
18830,18434,18878,9241,9637,9193,0.051088688,0.049311056,0.046032419,0.044151066,0.047836464,0.054497988
18245,17918,18347,9010,9337,8908,0.049438202,0.051400826,0.048127759,0.050055494,0.046267538,0.052761563
17495,15128,17401,7517,9884,7611,0.244069734,0.25713908,0.246882363,0.260476254,0.236543909,0.253843122
17785,15626,17957,7899,10058,7727,0.110936182,0.11077691,0.107924486,0.107355361,0.108371446,0.114274621
17185,15995,17692,8251,9441,7744,0.454000582,0.464270084,0.462129776,0.472669979,0.452918123,0.455320248
18752,18357,18823,9214,9609,9143,0.080418089,0.082638775,0.077830314,0.079986976,0.075762306,0.085311167
23292,22558,23316,11291,12025,11267,0.046410785,0.045394095,0.041988334,0.040828979,0.043076923,0.049968936
16071,14684,16023,7318,8705,7366,0.1766536,0.177472078,0.178431005,0.179420607,0.177599081,0.175536248
18628,18296,18664,9166,9498,9130,0.064097058,0.065642763,0.060062152,0.061531748,0.058643925,0.069769989
15733,14054,15853,7087,8766,6967,0.545159855,0.548242493,0.542988709,0.545788063,0.54072553,0.550739199
20562,18212,20226,8938,11288,9274,0.023392666,0.027070064,0.024720657,0.028641754,0.021615875,0.025555316
11049,9566,11077,4797,6280,4769,0.163091683,0.172694961,0.168818272,0.179278716,0.160828025,0.166072552
24052,23244,24060,11626,12434,11618,0.054590055,0.055110996,0.051288446,0.051694478,0.050908798,0.058529867
23642,23004,23722,11542,12180,11462,0.054225531,0.053295079,0.050501644,0.049471495,0.051477833,0.05714535
19391,16930,19441,8490,10951,8440,0.295962044,0.296633196,0.294892238,0.29540636,0.294493654,0.297867299
24539,23583,24516,11780,12736,11803,0.071559558,0.072001018,0.0680372,0.068336163,0.067760678,0.075658731
24198,23244,24238,11642,12596,11602,0.048309778,0.05033557,0.047074841,0.049046556,0.045252461,0.051629029
22171,21535,22326,10845,11481,10690,0.097289252,0.097376364,0.0942399,0.094236976,0.094242662,0.100561272
26135,25312,26147,12662,13485,12650,0.038377654,0.039388432,0.035338662,0.036250197,0.034482759,0.042529644
25548,24746,25620,12409,13211,12337,0.039142007,0.03960236,0.035675254,0.036022242,0.03534933,0.043203372
25316,24401,25295,12190,13105,12211,0.065097172,0.064136716,0.062660605,0.061607875,0.063639832,0.066661207
24499,23714,24571,11893,12678,11821,0.08988122,0.088597453,0.08689105,0.085512486,0.088184256,0.09170121
25209,24324,25221,12168,13053,12156,0.051291206,0.050115113,0.046945006,0.04561144,0.048188156,0.054623231
24888,24027,24881,12010,12871,12017,0.048336548,0.047238523,0.044290824,0.04304746,0.045451014,0.051427145
24983,24159,25072,12124,12948,12035,0.054477044,0.053272073,0.049377792,0.048003959,0.050664195,0.058579144
26489,25494,26515,12760,13755,12734,0.05390917,0.051973013,0.049141995,0.047021944,0.051108688,0.056934192
26245,25380,26345,12740,13605,12640,0.030215279,0.032348306,0.02953122,0.031632653,0.027563396,0.03306962
26204,25349,26295,12720,13575,12629,0.052282094,0.052585901,0.049781327,0.05,0.049576427,0.055190435
25238,24441,25265,12234,13031,12207,0.055273793,0.053189313,0.050227588,0.047981036,0.052336735,0.05840911
25260,24412,25354,12253,13101,12159,0.040617577,0.041536949,0.03739055,0.038194728,0.036638425,0.044905009
25628,24918,25754,12522,13232,12396,0.037810208,0.038646761,0.036266211,0.037054784,0.035519952,0.040254921
26407,25505,26450,12774,13676,12731,0.031809747,0.033013135,0.029565217,0.030687334,0.02851711,0.035346791
25217,24446,25275,12252,13023,12194,0.05337669,0.052114865,0.049376855,0.047992165,0.050679567,0.056257176
26763,25788,26795,12910,13885,12878,0.041736726,0.041414611,0.037880202,0.037412858,0.038314728,0.045426308
25822,24904,25794,12438,13356,12466,0.088838975,0.090346932,0.088470187,0.089966233,0.087076969,0.090726777
26300,25322,26324,12673,13651,12649,0.047034221,0.047429113,0.044142228,0.044425156,0.043879569,0.05043877
26506,25524,26504,12761,13743,12763,0.055270505,0.053479079,0.051916692,0.049996082,0.053700065,0.056961529
26573,25768,26645,12920,13725,12848,0.047830505,0.0476172,0.044436104,0.044117647,0.044735883,0.051136364
26377,25547,26462,12816,13646,12731,0.034575577,0.035581477,0.032763963,0.033707865,0.031877473,0.037467599
26706,25767,26775,12918,13857,12849,0.076462218,0.07703652,0.075704949,0.076250194,0.075196652,0.077827068
25062,24219,25115,12136,12979,12083,0.070026335,0.070564433,0.069122039,0.069627554,0.068649357,0.071505421
26636,25679,26735,12889,13846,12790,0.033863944,0.035125978,0.032017954,0.03320661,0.030911455,0.037060203
27051,26131,27168,13124,14044,13007,0.052937045,0.051701045,0.048917845,0.04754648,0.050199373,0.055892981
26207,25290,26277,12680,13597,12610,0.059793185,0.059905101,0.057236366,0.057255521,0.057218504,0.062569389
12604,11397,12817,5805,7012,5592,0.586559822,0.584803018,0.587032847,0.58535745,0.588419852,0.584227468
26623,25672,26701,12875,13826,12797,0.045975285,0.045964475,0.043369162,0.043262136,0.043468827,0.048683285
26770,25813,26853,12948,13905,12865,0.050354875,0.048580173,0.045209101,0.043249923,0.047033441,0.053944812
26673,25811,26764,12951,13813,12860,0.050200577,0.048855139,0.046629801,0.045170257,0.047998263,0.052566096
18782,16384,18670,8136,10534,8248,0.024118837,0.024963379,0.025709695,0.026794494,0.024871844,0.023157129
26491,25662,26571,12871,13700,12791,0.051866672,0.052217286,0.04764593,0.047859529,0.047445255,0.056602298
27285,26286,27347,13174,14173,13112,0.048231629,0.0471734,0.045196914,0.044026112,0.04628519,0.05033557
27118,26123,27157,13081,14076,13042,0.05051995,0.048998966,0.045218544,0.043498204,0.046817278,0.054516179
26459,25556,26569,12833,13736,12723,0.071620243,0.07168571,0.069140728,0.069118678,0.069161328,0.074274935
26916,25923,26889,12948,13941,12975,0.039270322,0.040195965,0.03663208,0.037457522,0.035865433,0.042928709
26821,25872,26797,12924,13873,12948,0.049923567,0.04978355,0.047803859,0.047585887,0.04800692,0.051977139
27036,26045,27089,13049,14040,12996,0.050007398,0.052486082,0.049429658,0.05188137,0.047150997,0.053093259
26771,25914,26935,13039,13896,12875,0.050950656,0.050204523,0.048449972,0.047626352,0.049222798,0.052815534
27050,26122,27040,13056,13984,13066,0.050092421,0.048885996,0.04637574,0.045036765,0.047625858,0.052732282
26907,25964,26917,12987,13930,12977,0.04864905,0.04914497,0.04603039,0.046431046,0.045656856,0.051860985
27197,26229,27288,13160,14128,13069,0.050336434,0.050707232,0.047017004,0.047264438,0.046786523,0.054174
26867,25849,26864,12923,13941,12926,0.050396397,0.052767999,0.048764145,0.051071733,0.046625063,0.054463871
29605,24635,29692,12361,17331,12274,0.007127174,0.008118531,0.006904217,0.007847262,0.006231608,0.008391722
20377,18173,20504,9150,11354,9023,0.71801541,0.718098278,0.719518143,0.719781421,0.719305971,0.716391444
40658,35175,41513,18015,23498,17160,0.006394805,0.007988628,0.007347096,0.009048016,0.006043067,0.006876457
26863,25958,26921,13008,13913,12950,0.060715482,0.060020032,0.058578805,0.057810578,0.05929706,0.062239382
27205,26283,27292,13185,14107,13098,0.057305642,0.057489632,0.055913821,0.05604854,0.055787907,0.058940296
26894,25890,26900,12948,13952,12942,0.048375102,0.047856315,0.044535316,0.043867779,0.045154817,0.051846701
34759,30869,34662,15386,19276,15483,0.980638108,0.981632058,0.980901275,0.981931626,0.980078855,0.981334367
31970,27223,32309,13781,18528,13442,0.384329058,0.385776733,0.380729828,0.381539801,0.380127375,0.390120518
29011,25947,29284,13110,16174,12837,0.729447451,0.730797395,0.732755088,0.734477498,0.731358971,0.727039028
39867,35585,40748,18233,22515,17352,0.050844056,0.055529015,0.05126632,0.055887676,0.047523873,0.055152144
34912,31219,35863,16085,19778,15134,0.339396196,0.334027355,0.337590274,0.332172832,0.341996157,0.335998414
44241,38983,44260,19501,24759,19482,0.992020976,0.991380858,0.992114776,0.991487616,0.992608748,0.991273997
26784,22678,26846,11370,15476,11308,0.94369773,0.941661522,0.943567012,0.941512753,0.945076247,0.941811107
58037,50309,58128,25200,32928,25109,0.267467305,0.269136735,0.265225021,0.266547619,0.264212828,0.271735234
44528,38751,44553,19388,25165,19363,0.278678584,0.284999097,0.279913811,0.286414277,0.274905623,0.28358209
54854,46937,54541,23312,31229,23625,0.027181245,0.027952362,0.027043875,0.027796843,0.026481796,0.02810582
61037,51321,61022,25653,35369,25668,0.045365926,0.049336529,0.043213923,0.046778155,0.040628799,0.051893408